🟦🟦🟦🟦🟦🟦🟦🟦🟦🟦🟦🟦🟦🟦🟦🟦🟦🟦🟦🟦🟦🟦🟦🟦🏠🏠🏠🏠🏠🏠🏠🏠🏠🏠🏠🏠🏠🏠🏠🟨🟨🏠🏠🏠🏠🏠🏠🏠🏠🏠🏠🏠🏠🏠🏠🏠🏠🏠🏠🏠🏠🏠🏠🏠🏠🏠🏠🏠🏠🏠🏠🏠🏠🏠🏠🏠🏠🏠🏠🏠🏠🏠🏠🏠🏠🏠🏠🏠🏠🏠🏠🏠🏠🏠🏠🏠🏠🏠🏠🏠🏠🏠🏠🏠🏠🏠
🟦🟦🟦🟦🟦🟦🟦🟦🟦🟦🟦🟦🟦🟦🟦🟦🟦🟦🟦🟦🟦🟦🟦🟦🌿🏠🏠🏠🏠🏠🏠🏠🏠🏠🏠🏠🏠🏠🏠🟨🟨🏠🏠🏠🏠🏠🏠🏠🏠🏠🏠🏠🏠🏠🏠🏠🏠🏠🏠🏠🏠🏠🏠🏠🏠🏠🏠🏠🏠🏠🏠🏠🏠🏠🏠🏠🏠🏠🏠🏠🏠🏠🏠🏠🏠🏠🏠🏠🏠🏠🏠🏠🏠🏠🏠🏠🏠🏠🏠🏠🏠🏠🏠🏠🏠🏠
🟦🟦🟦🟦🟦🟦🏠🏠🏠🟦🟦🟦🟦🟦🟦🟦🟦🟦🟦🟦🟦🟦🟦🟦🏠🏠🏠🏠🏠🏠🏠🏠🏠🏠🏠🏠🏠🏠🏠🟨🟨🏠🏠🏠🏠🏠🏠🏠🏠🏠🏠🏠🏠🏠🏠🏠🏠🏠🏠🏠🏠🏠🏠🏠🏠🏠🏠🏠🏠🏠🏠🏠🟨🏠🏠🏠🏠🏠🏠🏠🏠🏠🏠🏠🏠🏠🏠🏠🏠🏠🏠🏠🏠🏠🏠🏠🏠🏠🏠🏠🏠🏠🏠🏠🏠🏠
🟦🟦🟦🟦🟦🟦🟦🟦🟦🟦🟦🟦🟦🟦🟦🟦🟦🟦🟦🟦🟦🟦🟦🟦🏠🏠🏠🏠🏠🏠🏠🏠🏠🟨🏠🏠🏠🏠🏠🟨🟨🏠🏠🏠🏠🏠🏠🏠🏠🏠🏠🏠🏠🏠🏠🏠🏠🏠🏠🏠🏠🏠🏠🏠🏠🏠🏠🏠🏠🏠🏠🏠🏠🏠🏠🏠🏠🏠🏠🏠🏠🏠🏠🏠🏠🏠🏠🏠🏠🏠🏠🏠🏠🏠🏠🏠🏠🏠🏠🏠🏠🏠🏠🏠🏠🏠
🟦🟦🟦🟦🟨🏠🏠🏠🏠🏠🟦🟦🟦🟦🟦🟦🟦🟦🟦🟦🟦🟦🟦🟦🏠🏠🏠🏠🏠🏠🏠🏠🏠🏠🏠🏠🏠🏠🏠🟨🟨🏠🏠🏠🏠🏠🏠🏠🏠🏠🏠🏠🏠🏠🏠🏠🏠🏠🏠🏠🏠🏠🏠🏠🏠🏠🏠🏠🏠🏠🏠🏠🏠🏠🏠🏠🏠🏠🏠🏠🏠🏠🏠🏠🏠🏠🏠🏠🏠🏠🏠🏠🏠🏠🏠🏠🏠🏠🏠🏠🏠🏠🏠🏠🏠🏠
🟦🟦🟦🟦🟨🏠🏠🏠🏠🏠🟨🟦🟦🟦🏠🏠🏠🏠🟦🟦🟦🟦🟦🟦🌿🌿🏠🏠🏠🏠🏠🏠🏠🟨🏠🏠🏠🏠🏠🟨🟨🏠🏠🏠🏠🏠🌿🏠🌿🏠🏠🏠🏠🏠🏠🏠🏠🏠🏠🏠🏠🏠🏠🏠🏠🏠🏠🏠🏠🏠🏠🏠🏠🏠🏠🏠🏠🏠🏠🏠🏠🏠🏠🏠🏠🏠🏠🏠🏠🏠🏠🏠🏠🏠🏠🏠🏠🏠🏠🏠🏠🏠🏠🏠🏠🏠
🏠🟦🟦🟦🟨🏠🏠🏠🏠🏠🟨🟦🟦🟦🏠🏠🏠🏠🟦🟦🟦🟨🟨🟨🟨🟨🏠🏠🏠🏠🏠🏠🏠🟨🏠🏠🏠🏠🏠🟨🟨🏠🏠🏠🏠🟨🟨🟨🟨🟨🟨🟨🟨🏠🏠🏠🏠🏠🏠🏠🏠🏠🏠🏠🏠🏠🏠🏠🏠🏠🏠🏠🏠🏠🏠🏠🏠🏠🏠🏠🏠🏠🏠🏠🏠🏠🏠🏠🏠🏠🏠🏠🏠🏠🏠🏠🏠🏠🏠🏠🏠🏠🏠🏠🏠🏠
🏠🟦🟦🟦🟨🟨🟨🟨🟨🟨🟨🟦🟦🟦🏠🏠🏠🟦🟦🟦🪵🟨🟨🟨🟨🟨🟨🟨🟨🟨🟨🟨🟨🟨🟨🟨🟨🪨🪵🟨🟨🪵🪨🟨❎❎🟨❎🟨🟨🟨🟨🟨🟨🏠🏠🏠🏠🏠🏠🏠🏠🏠🏠🏠🏠🏠🏠🟨🟨🟨🟨🌿🏠🏠🏠🏠🏠🏠🏠🏠🏠🏠🏠🏠🏠🏠🏠🏠🏠🏠🏠🏠🏠🏠🏠🏠🏠🏠🏠🏠🏠🏠🏠🏠🏠
🏠🟦🟦🟦🟨🟨🟨🟨🟨🟨🟨🟦🟦🟦🟦🟦🟦🟦🟦🟦🟨🌳🟨🟨🟨🟨🟨🟨🟨🟨🟨🟨🟨🪨🟨🟨🟨🪨🟨🟨🟨🪨🟨🟨🟨🟨🟨🟨🟨🪨🟨🟨🟨🟨🏠🏠🏠🏠🏠🏠🏠🏠🏠🏠🏠🏠🏠🏠🟨🟨🟨🟨🏠🟨🏠🏠🟨🟨🟨🏠🏠🏠🏠🏠🏠🏠🏠🏠🏠🏠🏠🏠🏠🏠🏠🏠🏠🏠🏠🏠🏠🏠🏠🏠🏠🏠
🟦🟦🟦🟦🟨🟨🟨🟨🟨🟨🟨🟦🟦🟦🟦🟦🟦🟦🟦🟦🟨🟨🟨🟨🟨🟨🟨🟨🟨🟨🟨🟨🟨🟨🟨🌳🟨🟨🟩🟨🟨🟨🪨🟨🌳🟨🪨🟨🪵🟨🟨🟨🟨🟨🟨🟨🟨🟨🟨🟨🟨🟨🟨🟨🟨🟨🟨🟨🟨🟨🟨🟨🟨🟨🏠🏠🟨🟨🟨🟨🏠🏠🏠🏠🏠🏠🏠🏠🏠🏠🏠🏠🏠🏠🏠🏠🏠🏠🏠🏠🏠🏠🏠🏠🏠🏠
🟦🟦🟦🟦🟦🟨🟨🟨🟨🟨🟨🟦🟦🟦🟦🟦🟦🟦🟦🟨🟨🟨🟨🟨🟨🟨🟨🟨🟨🟨🟨🟨🟨🟨🟨🟨🟨🟨🟨🟨🟨🟨🟨🟨🟨🟨🟨🌳🟨🟨🟨🟨🟨🟨🟨🟨🟨🟨🏠🏠🏠🏠🏠🏠🏠🏠🏠🟨🟨🟨🟨🟨🟨🟨🟨🟨🟨🟨🟨🟨🏠🏠🏠🏠🏠🏠🏠🏠🏠🏠🏠🏠🏠🏠🏠🏠🏠🏠🏠🏠🏠🏠🏠🏠🏠🏠
🟦🟦🟦🟦🟦🟦🟦🟦🟦🟦🟦🟦🟦🟦🟦🟦🟦🟦🟦🪨🟨🟨🟨🟨🟨🟨🟨🟨🟨🟨🟨🟨🟨🟨🟨🪵🟨🟨🟨🪵🪵🟨🟨🟨🟨❎🟨🪵🟨🟨🟨🟨🟨🪨🟨🟨🟨🟨🏠🏠🏠🏠🏠🏠🏠🏠🏠🟨🟨🟨🟨🟨🟨🟨🟨🟨🟨🟨🟨🌿🌿🏠🏠🏠🏠🏠🏠🏠🏠🏠🏠🏠🏠🏠🏠🏠🏠🏠🏠🏠🏠🏠🏠🏠🏠🏠
🟦🟦🟦🟦🟦🟦🟦🟦🟦🟦🟦🟦🟦🟦🟦🟦🟦🟦🟦🟨🟨🪨🟨🟨🟨🟨🟨🟨🟨🟨🟨🟨🟨🟨🟨❎🟨❎🟨🪵🪵🪵🟨🟨🪨🟨❎🟩🟨🟨🟨🌳🟨🟨🟨🟨🟨🟨🏠🏠🏠🏠🏠🏠🏠🏠🏠🟨🟨🟨🟨🟨🟨🟨🟨🟨🟨🟨🟨🟨🟨🏠🏠🏠🏠🏠🏠🏠🏠🏠🏠🏠🏠🏠🏠🏠🏠🏠🏠🏠🏠🏠🏠🏠🏠🏠
🟦🟦🟦🟦🟦🟦🟦🟦🟦🟦🟦🟦🟦🟦🟦🟦🟦🟦🟦🟦🟨🪨🟨🟨🟨🟨🟨🟨🟨🟨🟨🟨🟨🟨🟨🟨🟨🟨❎🟨❎🟨🟨🟨❎🟩🟩🟩🟩🟩🪵🟨❎🟨🟨🟨🌳🟨🏠🏠🏠🏠🏠🏠🏠🏠🏠🟨🟨🟨🟨🟨🟨🟨🟨🟨🟨🟨🟨🟨🟨🏠🏠🏠🏠🏠🏠🏠🏠🏠🏠🏠🏠🏠🏠🏠🏠🏠🏠🏠🏠🏠🏠🏠🏠🏠
🟦🟦🟦🟦🟦🟦🟦🟦🟦🟦🟦🟦🟦🟦🟨🟨🟦🟦🟦🟦🟨🟨🟨🟨🟨🟨🟨🟨🟨🟨🟨🟨🟨🟨🟨❎🪵🟨🟨❎🟨❎🌳❎🟨🟩🟩🟩🟩🟩🟨🪵🟨🟨🟨🟨🟨🟨🏠🟨🟨🟨🟨🟨🟨🟨🏠🟨🟨🟨🟨🟨🟨🟨🟨🟨🟨🟨🟨🏠🏠🏠🏠🏠🏠🏠🏠🏠🏠🏠🏠🏠🏠🏠🏠🏠🏠🏠🏠🏠🏠🏠🏠🏠🏠🏠
🟦🟦🟦🟦🟦🟦🟦🟦🟦🟨🟨🟨🟨🟨🟨🟨🟦🟦🟦🟦🟨🟨🟨🟨🟨🟨🟨🟨🟨🟨🟨🟨🟨🟨❎❎🟨🪨🟨🟨❎🟨🟨🟨🟨🟩🟩🟩🟩🟨🟨🟨🟨🟨🟨🟨🟨🟨🏠🏠🏠🏠🟨🟨🟨🏠🏠🏠🟨🟨🟨🟨🟨🟨🟨🟨🟨🟨🟨🟨🟨🏠🏠🏠🏠🏠🏠🏠🏠🏠🏠🏠🏠🏠🏠🏠🏠🏠🏠🏠🏠🏠🏠🏠🏠🏠
🟦🟦🟦🟦🟦🟦🟦🟦🟦🟨🟨🟨🟨🟨🟨🟨🟦🟦🟦🟦🟨🟨🟨🪵🟨🟨🟨🟨🟨🟨🟨🟨🟨🟨🪨🌳❎🟨❎❎🟨❎🪵🟨🌳🟩🟩🟩🟩🟨🪨🟨🟨🟨🪨🟨🟨🟨🟨🌳🏠🏠🟨🟨🟨🟨🟨🟨🟨🟨🟨🟨🟨🟨🟨🟨🟨🟨🟨🟨🟨🏠🏠🏠🏠🏠🏠🏠🏠🏠🏠🏠🏠🏠🏠🏠🏠🏠🏠🏠🏠🏠🏠🏠🏠🏠
🟦🏠🏠🏠🏠🟦🟦🟦🟦🟦🟨🟨🟨🟨🟨🟦🟦🟦🟦🟦🟨🟨🟨🟨🟨🟨🟨🟨🟨🟨❎🟨🪨🟨🌳🟨❎🟨🟨❎🌳🟨🟨🟨🟨🟩🟩🟩🟩🟩🟨🟨🟨🟨🟨🟨🟨🟨🟨🟨🤖🟨🟨🟨🟨🟨🟨🟨🟨🟨🟨🟨🟨🟨🟨🟨🟨🟨🟨🟨🟨🏠🏠🏠🏠🏠🏠🏠🏠🏠🏠🏠🏠🏠🏠🏠🏠🏠🏠🏠🏠🏠🏠🏠🏠🏠
🟦🏠🏠🏠🏠🟦🟦🟦🟦🟦🟦🟦🟦🟦🟦🟦🟦🟦🟦🟦🟨🟨🟨🌳🟨🪵🟨🟨🪨🟨🟨🪵❎🟨🟨🪨🪵🪵🟨🪨❎🟨❎🟨❎🟩🟩🟩🟩🟨🟨🟨🟨🪨🟨🟨🟨🟨🟨🟨🟨🟨🟨🌱🌱🌱🌱🌱🌱🌱🌱🌱🌱🟨🟨🟨🏠🏠🏠🏠🏠🏠🏠🏠🏠🏠🏠🏠🏠🏠🏠🏠🏠🏠🏠🏠🏠🏠🏠🏠🏠🏠🏠🏠🏠🏠
🟦🟦🏠🏠🟦🟦🟦🟦🟦🟦🟦🟨🟨🟨🟦🟦🟦🟦🟦🟦🌳🟨🟨🟨🟨🟨🟨🟨🟩❎🟩❎🪨🟨🟨🪵🪵🪵❎🟨🟨🟨🪨🟨🟨🪨🪵🟩🌳🟨🟨🟨🪵🟨❎🟨🟨🪨🟨🪵🟨🟨🟨🟨🌱🌱🌱🌱🌱🌱🌱🌱🟨🟨🟨🟨🏠🟨🟨🟨🟨🪵🟩🟩🟩🟩🟩🟩🟩🟩🟩🟩🟨🟨🟩🟩🟩🟩🟩🟩🟩🟩🟩🏠🏠🏠
🟦🟦🟦🟦🟦🟦🟦🟦🟦🟦🟦🏠🟨🟨🟦🟦🟦🟦🟦🟨🟨🟨🪨🪨❎🟨🪨🪵🟩🟩🟩🟩🟩🟩❎❎🟨🟨❎❎🟨🟨🟨❎🟨❎❎🟨🟨🟨❎❎🪵🟨🟨🟩🟩🟩🪨🟨🟨🟨🟨🌱🌱🌱🌱🌱🌱🌱🌱🌱🟨🟨🟨🟨🏠🟨🏠🏠🟨🪨🟩❎🟩🟩🟩🟩🟩🟩🟩🟩🪵🌳🟩🟩🟩🟩🟩🟩🟩🟩🟩🏠🏠🏠
🟦🟦🟦🟦🟦🟦🟦🟦🟦🟦🟦🟦🟦🟦🟦🟦🟦🟦🟦🟨❎❎🟨🟨🪵🟨🟩🟩🟩🟩🟩🟩🟩🟩🟩🟨❎🟨🟨🪨🟨🌳🟨🪨🪵🟨🟨🪨🟨🟨🟨❎🟨❎🟨🟩🟩🟩🟩🌳🪨🟨🟨🌱🌱🌱🌱🌱🌱🌱🌱🌱🟨🟨🟨📦🏠🟨🏠🏠🪨🟩🟩🟩🟩🟩🟩🟩🟩❎🟨❎🟨🟩🟩🟩🟩🟩🟩🟩🟩🟩🟩🏠🏠🏠
🟦🟦🟦🟦🟦🟦🟦🟦🟦🟦🟦🟦🟦🟦🟦🟦🟦🟦🟦🟨🟨🟨🟨🪨🟨🟨🟩🟩🟩🪵🟩🟩🪨🟩🟩🟨🟨🟨❎🟨🟨🟨🟨🪨❎🟨❎❎❎🪨🟨🌳🪨🟨❎🟩🟩🟩🟩🟩🟨🌳🟨🟨🌱🌱🌱🌱🌱🌱🌱🌱🟨🟨🟨🟨🏠🏠🏠🟨🟨🟩🟩🟨🟩🌳🟨🪵🟩🟨🟨🟨🪵🟨🟩❎🟩🟩🟩🟩🟩🟩🟩🏠🏠🏠
🟦🟦🟦🟦🟦🟦🟦🟦🟦🟦🟦🟦🟦🟦🟦🟦🟦🟦🟨❎🟨🟨🟨🪨🟨🟩🟩🟩🟩🟩🟩🟩🟩🟩🟩🟩🟨🟨🟨❎🪨🪵❎🟨🟨🟨🟨❎🟨🪵🟨🪵🟨🟨🟩🟩🟩🟩🟩❎🪨🟨🟨🟨🌱🌱🌱🌱🌱🌱🌱🌱🟨🟨🟨🟨🏠🏠🏠🟨🟨🪨🟩🟩🟩🟩🪨🪨🪵🪨🪵🟨🪨🟨❎🟨🟨❎❎🟩🟩🟩🟨🏠🏠🏠
🟦🟦🟦🟦🟦🟦🟦🟦🟦🟦🟦🟦🟦🟦🟦🟦🟦🟦🟨❎🪵🪨🟨🟨🟨🌳🟩🟩🟩🟩🟩🟩🟩🟩🟩🟩❎🟨🌳🌳🟨🟨🟨❎🟨🌳🪵🌳❎🌳🟨🟨❎🪨🟨🟩🟩🟩❎🟨🪵🟨🟨🌱🌱🌱🌱🌱🌱🌱🌱🌱🟨🟨🟨🟨🏠🏠🏠🏠🟨🟨🟨❎🟨🟩🟩❎🪨🟨🪨🟨🪵🪨🟨🟨🟨🪨🟩🟩🟩🌳🟨🏠🏠🏠
🟦🟦🟦🟦🟦🟦🟦🟦🟦🟦🟦🟦🟦🟦🟦🟦🟦🟦🟨❎🟨🟨🟨🟨🟨🟩🟩🟩🪨🟩🟩🟩🪵🟩🟩🟩🟨❎🟨🪨🟨🪨🟨❎🟨🟨🟨🟨🪨🌳🌳🟨🟨🟨❎🟨❎❎🟨🪨❎❎🟨🪨🟨🟨🟨🟨🟨🟨🟨🟨🟨🟨🟨🟨🟨🟨🟨🟨🟨🟨🟨🟨❎🟨🟩🟨🪨❎🪵🟨🟨🪨❎❎🟨❎❎🟨🪵🪵🟨🏠🏠🏠
🟦🟦🟦🟦🟦🟦🟦🟦🟦🟦🟦🟦🟦🟦🟦🟦🟦🟦🟦🟨🟨🪨❎🟨🟨❎🟩🟩🟩🟩🟩🟩🟩🟩🟩🟩🟩🟨🟨🟨🟨🟨🌳🪨🟨🟨❎🟨🟨❎🟨🟨❎🌳🟨❎🟨❎🟨🟨❎🟨🟨🟨🟨🟨🟨🟨🟨🟨❎🟨🟨🟨🟨🟨🟨🟨🟨🟨🟨🟨🟨🟨🟨🟨🟨🟨🟨🟩🟩🟨❎🟨🟨🪵❎🟨🟨❎🟨❎🟨🏠🏠🏠
🏠🏠🏠🏠🏠🏠🟦🟦🟦🟦🟦🟦🟦🟦🟦🟦🟦🟦🟦🟨🪵🟨🟨🟨❎🟨🪵🟩🟩🟩🟩🟩🟩🟩🟩🟩❎🟨🪵🟨❎🟨🟨🟨🪨🟨🌳🌳🟨🟨🟨🪨🟨❎❎🟨🟨🟨🟨❎🟨❎🟨🟨🪵🪨🟨🟨🟨🟨🟨🟨🟨🟨🟨🟨🏠🏠🏠🏠🟨❎🟨🪨🪨🟨🟨🟨🟨🟨🟩🟨🟩🟩❎🪨🟨❎🪨🪵🪵🟨🟨🏠🏠🏠
🏠🏠🏠🏠🏠🏠🏠🟦🟦🟦🟦🟦🟦🟦🟦🟦🟦🟦🟦🟨🪨❎🌳🟨🟨❎🟨🟨🟨🟩🟩🟩🟩🪨❎🟨🌳🟨✨🟨❎🟨🪨❎🟨❎🟨🟨❎❎🪵🟨🟨🌳🟨🟨🪵🟨❎🟨🟨🟨🌳🪨🟨🟨🟨🟨❎🟨🟨🌳🟨🟨🌳🟨🏠🟩🟩🟩🟨❎🟨🟨🟨🟨🟨🟨🟨🟨🟩🟩🟩🟩🟩🪵🟨🟨🟨🪵🪵🌳🟨🏠🏠🏠
🏠🏠🏠🏠🏠🏠🏠🏠🟦🟦🟦🟦🟦🟦🟦🟦🟦🟦❎🪵🟨🟨🟨🟨🟨🟨🟨❎🪨🟨❎🟩🟨🟨🟨❎🟨🟨❎🟨🌳🟨🟨🟨🌳🪨🟨❎❎🟨🟨❎🪨🟨🟨🌳🟨🪨🟨🟨🌳🟨🟨🟨🟨🟨🟨🟨🟨🟨🟨🟨🪨🪵🟨🟨🏠🟩🟩🟩🟨❎🟨🟨🟨🟨🟨🟨🟨🟨🟨🟩🟩🟩🟩🟨❎❎🪵🪨🟩🟩🟩🏠🏠🏠
🏠🏠🏠🏠🏠🏠🏠🏠🏠🟨🟦🟦🟦🟦🟦🟦🌳🟨🟨❎🪨❎🟨🟨🌳🟨🪵🟨❎🟨🪵🟨❎🌳🟨🟨🟨❎❎❎🟨🟨❎🟨🟨🟨🟨🟨❎🟨🟨🪨🌳🟨🟨🪨🟨🟨🟨❎🟨🪨🟨🟨🟨🟨🟨🟨🟨🟨🟨🟨🟨🟨🟨🟨🏠🟩🟩🟨🌳🟨🌳🟨🟨🟨🟨🟨🟨🟨🟨🟩🟩🟩🟩🟩🪨❎🟨🪨🟩🟩🟨🏠🏠🏠
🏠🏠🏠🏠🏠🏠🏠🏠🏠🟨🟨🌿🌿🌿🟨🟨🟨🟨🪨🟨🟨🟨🟨🟨🟨🟨🪨🟨🟨🟨🟨🟨🟨🟨🟨🪵🪵🌳🟨🟨🪵🟨🟨🟨❎❎🪵🟨🟨🟨❎🟨🟨❎🟨🪨🟨🌳❎🟨🟨🪵🟨🪵🟨🟨🟨❎🟨🟨🟨🟨🪨🟨🟨🟨🏠🟨❎🪨🟨🟨🟨🟨🟨🟨🟨🟨🟨🟩🌳❎🟩🟩🟩🟩🟩❎🪨🪨🟩🟩🟩🏠🏠🏠
🏠🏠🏠🏠🏠🏠🏠🏠🏠🏠🟨🟨🟨🟨🟨🟨🟨🟨🟨❎🟨🪨🟨🪵🟨🟨🟨🌳🌳🪵❎🟨🟨❎🟨🪵🪵🟨❎🟨🟨🌳🌳🟨🟨❎🟨🟨🌳🟨🟨🟨🪨❎🪵🟨🟨❎🟨🟨🟨🟨🟨🟨🟨🟨🪨🟨🌳❎🟨🪨❎🟨❎🪨🏠🟩🟩🟨🟨🪨🟨🟨🟨🟨🟨🪨🟨🟩🟩🟩🟩🟩🟩🟩🌳🟨🟨🟨🟩🟩🟩🏠🏠🏠
🏠🏠🏠🏠🏠🏠🏠🏠🏠🏠🏠🏠🟨🟨🟨🟨🟨🪨🟨🪨🟨🟨❎🟨🟨🪨🟨🪨🟨🟨🟨🪨🟨❎🪵❎🌳🟨🟨🟨❎🟨🟨🟨🪨🟨❎🟨🟨❎🪨🪵🟨🟨🟨🟨❎🟨🟨🟨🪨🟨🟨🌳🪨🟨🟨❎🟨🟨❎❎🟨❎🟨🟨🏠🟩🟩🟩🪨❎❎🟨🟨🟨🟨🪵🟩🟨🟩🟩🟩🟩🟩🟩🟩🟩🌳🟨🟩🟨🟩🏠🏠🏠
🏠🏠🏠🏠🏠🏠🏠🏠🏠🏠🏠🏠🏠🟨🟨🟨🟨🟨🟨🟨🟨🪨🟨❎🟨🟨🪵🟨🪨🟨🌳🟨🟩🟨❎❎🟨🟨🌳🟨🌳🟨🪨🟩🪨🟨🟨🟨🟨🟨🟨❎🟨🌳🟨🟨🟨🟨🟨🪵🌳🟨🟨🟨🌳🪨🟨🟨🌳🟨🟨🟨🟨🟨❎🟨🏠🟩🟩🟩🟩🟨🪵🌳🪨🪨🟨🟨🌳🟩🟩🟩🪵🟩🟩🟩🟩🟩🟩🟩🟨🟨🟨🏠🏠🏠
🏠🏠🏠🏠🏠🏠🏠🏠🏠🏠🏠🏠🏠🟨🟨🟨🌳🟨❎🟨🟨❎❎🟨❎🟨🟨❎🟩🟩🟩🟩🟩❎🟨🟨🪵🟨🟨🪵🟨🟨🟨🟩🌳🟨🟨🪨❎🟨❎🟨🟨🟨🟨🟩❎🟩🌳🟨🟨🟨🟨🟨🪨🟨🌳🟨🪵🪨❎🟨🟨🌳🟨❎🏠🟩🟩🟩🟩❎🪵❎🟨🟨🟨🟨🟩🟩🟩🟩🟩🟩🟩🟩🟩🟩🟩🟨🟨🟨🟨🏠🏠🏠
🏠🏠🏠🏠🏠🏠🏠🏠🏠🏠🏠🏠🏠🟨🟨🟨🪨❎🟨🪨🟨❎❎🟨🟨❎❎🟩🟩🟩🟩🟩🟩❎🟨🪵🟨🟨🟨🟨🟨🌳🟩🟩🌳🟨🟨❎🟩🪵🪵🟩🟩🟩🟨🟩🟩🟩🟨🟨🟨🟨🪵❎🟨🟨🟨❎🟨🌳🌳🟨🪨🟨🪨🟨🏠🟩🟩🟩🟩🌳🟨🪵🟨🟨🟨🪵🪵🟩🟩🟩🟨🪨🟩🟩🟩🪨🟩🟩🟨🟨🟨🏠🏠🏠
🏠🏠🏠🏠🏠🏠🏠🏠🏠🏠🏠🏠🟨🌿🟨🟨🟨✨🪵🟨🟨🟨❎🟨🟨🪨🟩🟩🟩🟩🟩🟩🟩🟩🟨🟨🪵🟨🟨❎🟩🟩🟩🟩🟩🟩🟩🟩🟩🟩🟩🟩🟩🟩🟩🪵🪵🟩🪵🟨🟨🟩🟩🟩❎🟨❎🪵❎🟨🟨🟨🟨🪵🟨🪨🏠🟩🟩🟩🟩🟩❎❎🪨🟨🟨🪵🪵🟨🟨🟨🟨🟨🟩🟨🟨🟨🟨🟨🟨🟨🟨🏠🏠🏠
🏠🏠🏠🟨🏠🏠🟨🏠🏠🏠🏠🟨🟨🟨🟨🟨🪨❎🟨🟨🟨❎🟨❎🪨🟩🟩🟩🟩🟩🟩🟩🟩🟩🪨🟨❎🪨❎🪵❎🟩🟩🟩🟩🟩🟩🟩🟩🟩🟩🟩🟩🪨🟩🪵🪵🟩🟩🟨🟨🟩🟩🟩🟩🟩🟩🌳🟨🟨🟨🌳🟨🟨🪨🟨🏠🏠🏠🏠🏠🏠🏠🏠🟨🟨🟨🏠🏠🏠🏠🏠🏠🏠🏠🏠🏠🏠🏠🏠🏠🏠🏠🏠🏠🏠
🏠🌿🌿🌿🟨🟨🌿🟨🏠🏠🟨🌿🌿🟨🟨🟨🟨🟨🟨🌳❎🟨🟨🌳🟨❎🟩🟩🟩🪵🪵🟩🟩🟩❎🪵🪵🪵🟨🪨❎🟩🌳🟩🟩🟩🟩🟩🟩🟩🪵🟩🟩🟩🟩🟩🟨🟨🟨🟩🪵🪵🟩🟩🟩🟩🪨🟨🌳🟨🟨🟨❎🟨🟨❎🏠🟨🟩🌳🟨🟨🟨🪨🟨🟨🟨🟨🟨🟨🟨🟨🟨🟨🟨🟨🌳🟨🟩🟩🟨🏠🏠🏠🏠🏠
🏠🟨🟨🟨🟨🟨🌿🌿🟨🟨🟨🟨🟨🟨🟨🟨❎🟨❎🟨🟨❎🪨🟨❎🟩🟩🟩🟩🪵🪵🟩🟩🟩🟩🪵🪵❎❎❎🟩🟩🟩🟩🟩🟩🪵🪵🟩🟩🟩🟩🟩🪵🪵🟨🟨🟩🟩🟩🪵🪵🟩🟩🟩🟨🟨🟨🟨🟨🪨🪨🟨❎❎🟨🏠🟨🟨🟨🟨🟨❎🟨🟩🟨🪨🪨🟨🪵🟨🟨🟨🟨🪵🪵❎❎🟩🟩🟨🏠🏠🏠🏠🏠
🏠🟨🟨🟨🟨🟨🟨🟨🟨🟨🟨🟨🟨🟨🟨🟨🪨🟨🟨🟨🪵🟨🪨❎❎🌳🟩🟩🟩🟩🟩🟩🟩🟩❎❎❎🪨🪵🪵❎❎🟩🟩🪵🟩🪵🪵🟩🟩🟩🟩🟩🪵🪵🟨🟨🟩🟩🪨🟩🟩🟩🟩🟩🌳🟨❎🟨🟨🪵❎🟨🟨🟨❎🏠🟨🟨🟨🟨🟩🟩🟩🟩🟨🪵❎❎🟨🌳🟨🟨🟨🟨🟨❎🟨🪨🟨🟨🟨🟨🏠🏠🏠
🏠🌿🟨🪵🪵🟨🟨🟨🟨🟨🟨🟨🟨🟨🟨🟨🟨🟨🟨❎❎🟨❎🟨❎❎🟩🟩🟩🟩🟩🟩🟩🟩🟩🪵🪨🟨🪵🪵🪨❎🟩🟩🟩🟩🟩🟩🟩🟩🟩🟩🟩🟨🟨🟨🟨🪵🪵🟩🟩🟩🟩🟩🟩🟩❎🟨❎🟨🟨🟨🌳🪨🟨🟨🏠🟨🌳🪵🪵🪨🟩❎❎🟨❎🟨🪨🪨🟨🟨🟨🟨🪵🟨🟨🌳🟨🟨🟨🟨🟨🏠🏠🏠
🏠🟨🟨🪵🪵🟨🟨🟨🟨🟨🟨🟨🟨🟨🟨🟨❎🟨🟨🟨🟨❎🟨🟨🟨❎🪨🟩🟩🟩🟩🟩🟩🟩❎🪨🪨🪨🪨❎🪵🟨🟨🟩🌳🟩🟩🟩🪨🟩🟩🟩🟨🟨🟨🟨🟩🪵🪵🟩🟩🟩🪵🟩🟩❎🟨❎🟨🟨❎❎❎🟨❎❎🏠🟨🟨🟨❎🟩🟩🟩🟩❎❎🟨🟨🟨🟨🟨🟨🪨❎🟩❎🟨🟨❎❎🟨🟨🏠🏠🏠
🏠🟨🟨🟨🟨🟨🟨🟨🟨🟨🟨🟨🟨🟨🟨🟨❎🟨🪵🪨❎🟨🟨🟨🌳🟨🟨🟩🟩🟩🟩🟩🟨🟨🟨🪨🪨🪨🟨🟨❎❎❎🟩🟩🟩🟩🟩🟩🟩🪵🪵🟨🟨🟨🟩🟩🟩🟩🟩🟩🟩🟩🌳🟩🟨🪨🌳🟨🟨🟨🪨🟨🪵🟨🟨🏠❎❎🟨❎🟨🪵🪨❎🟨🟨❎🪨🟨🟨🟨🟨🟨❎🟩🪨🟩🟩🟩❎🟩🟩🏠🏠🏠
🏠🟨🟨🟨🟨🟨🟨🟨🟨🌿🌿🟨🟨🟨🟨🟨🟨❎🟨🟨🟨🟨❎🪨🪨🟨❎🟩❎🪨🟩🪵🟨🟨❎🟨🟨🪨🪵🟨❎🟨🟨❎🟨❎🟩🟩🟩🪨🪵🪵🟨🟨🪵🟩🟩🟩🌳🟩🟩🟩🟩🟩🟩🟨❎🟨🟨❎🟨❎🪵🟨🟨❎🏠🟨🟨🟨🟨❎🟨🪵🟨🟨🌳🟨🪨🟨🟨🟨🟨🟨❎🟩🟩🟩🟩🟩🟩🟩🟩🏠🏠🏠
🏠🌿🌿🟨🟨🟨🪵🪵🟨🟨🌿🟨🟨🟨🟨🟨🪵🌳🟨❎🟨❎🪵🪵🟨🟨🟨🟨❎🟨🪨🟨🟨🌳🟨🟨🪵🪵🟨🟨🟨🟨🌳🟨❎🟨🟨🌳🟨🟨🟨🟨🟨🟨🟨🟩🟩🟩🟩🟩🟩🟩🟩🟩🌳❎🌳❎🟨🪵❎🟨🟨❎🪨🪨🏠🟨🟨🟨🪵❎🟨❎🟨❎🟨🟨🟨🟩🟩🟨🌳🟨🟩🟩🟩🟩🟩🟨🟨🟨🟨🏠🏠🏠
🏠🟨🟨🟨🟨🟨🪵🪵🟨🟨🟨🟨🟨🟨🟨🟨🟨❎🟨🟨🪨🟨🟨🌳🟨🟨🟨🟨🌳🟨🟨🟨🪨🟨🟨🟨🟨🟨❎🟨🪵🟨🌳🪵🟨🟨❎🟨🟨🟨🟨🌳🟨🟨🟩🟩🌳🟩🟩🟩🟩🟩🟩🟩🟨🌳🟨🟨❎🪨🟨❎❎❎🟨❎🏠🟨🟨🟩🟨❎🟨🪵🪨🟨🟨🪵🟩🟩🟨🟨🟨🟩🟩🟩🪨🟩🟨🟨🌳❎🟨🏠🏠🏠
🏠🟨🟨🟨🟨🟨🟨🟨🟨🟨🟨🟨🟨🟨🟨🟨🟨🟨🌳🟨🟨🟨🌳🟨🟨🪨🟨❎🟨❎🪨🟨🌳🪨🟨🟨❎🪵🟨🟨🪨🪨❎🟨🪨🟨🟨🟨🪨🟨🟨🟨❎🟨🪨🟨❎🟩❎🟩🌳🌳🟩🟨❎🟨❎🟨🟨❎❎🌳🟨🪵🟨🟨🏠🟨🟩🟩🟨❎🟨🟨🟨🟨🟨🟩🟩❎🟨🟨🟨🟨🟩🟩🟩🟨🪵🪵🟨🪨🟨🏠🏠🏠
🏠🟨🟨🟨🟨🟨🟨🟨🟨🟨🟨🟨🟨🟨🟨🟨🟨🟨🟨🟨❎🌳❎🌳❎🟨🟨🌳🟨🟨🪵🟨❎🟨🟨🌳❎🟨🪨🟨🟨🌳🟨🪵🟨🌳🪨🪨🪨🟨🪨🟨🟨🟨🪨❎🟨🟨🟨🟨❎🟨🟩🟩🟨❎🟨❎🪨🟨🟨🟨❎❎🪨🟨🏠🟩🟩🟩🟩❎🟨🟨🟩🪨🟩🟩🟩🟩🟩🟨🟨🌳🟩🟩🟩❎🟨🟨🟨❎🟨🏠🏠🏠
🏠🟨🟨🟨🟨🟨🌿🟨🟨🟨🟨🟨🟨🟨🟨🟨❎🟩🪵🟨🟨🟨❎🟨🟨🟨🟨❎🟨🟨🌳🟨🟨❎❎❎🟨🪵🪨🪨❎🪨❎🟨🟨🟨🟨🪨🪨🟨🟨🪨🟨🪨🪨🟨🟨❎🪨🪨🟨🟨❎🪨🟨🟨❎🟨🟨🪨🪨🪨❎🟨❎🟨🏠🏠🏠🟩🟩🟩🟨🪵🟩🟩🟩🟩🟩🟩🟨🟨🟨🟨🟩🟩❎🌳❎🟨❎❎🟨🏠🏠🏠
🏠🌿🟨🪵🪵🟨🟨🟨🟨🟨🟨🟨🟨🟨🟨🟩🟩🟩🟩🟨🌳🟨🟨❎🟨🌳🟨🟨🪵🟨🟨🟨🟨🟨🟨🟨🪨🟨🪨🪨🌳🟨🟨🟨🌳❎🟨🪨🟨🟨🪨🟨🪨🪨🪨❎🟨❎❎🪨🪨🪨🟨🟨🪨🟨❎🪨🟨🪨🪨🟨❎🪨🟨❎🏠🏠🏠🟨🟨🟨🟨🟨🌳🪵🪵🟩🟩🟩🟨🟨🟨🟨🪨🟨🪵🟨🪵🪵🟨❎🟨🏠🏠🏠
🏠🏠🟨🪵🪵🟨🟨🟨🟨🟨🌿🟨🟨🟨🟨🟩🟩🌳🟨🪨🟨🪵🪨🟨🟨🪨🟨❎🟨❎🟨🪨🟨🌳🟨🪨🪨🪨🟨❎🟨❎🪵❎🟨🟨🟨🟨🟨🟨🟨🟨🟨🪨🟨🟨🪨🪨🟨🪨🪨❎🪨🪨🪨🪨🟨🟨🪨🟨🪵❎🟨🟨🟨🟨🏠🏠🏠🏠🟨❎🟨🌳🟨🪵🪵🪨🟩🟩🟨🟨🟨🟨🟩🟨❎❎🪵🪵❎🟨🟨🏠🏠🏠
🏠🏠🟨🟨🟨🟨🟨🟨🟨🟨🟨🟨🟨🟨🟨🟨❎🟨🪨🟨🟨🟨🟨🪨🪨🪨🟨🟨🟨🟨🟨🟨🪨🟨🟨🟨🪨🪨❎🟨❎🪨🟨🟨🟨🪵🟨🟨🟨🪨❎🪨🟨🪵🟨🪨🪨❎🟨❎❎🪨❎🟨🪨🪨🟨🪨🟨❎🪨🟨🟨🟨🟨❎🟨🟨🟨🟨🟨🟨❎🟨❎❎❎🟨🟩🟩🟨🟨🟨🟨🟩🟩🟨🪵❎🪵🟩🟩🟩🏠🏠🏠
🏠🏠🏠🟨🟨🟨🪵🪵🟨🟨🟨🟨🟨🟨🟨🟨🟨🟨🟨🟨🟨🟨❎🪨🪨🟨🪵🟨🟨🟨🟨❎❎🟨❎🪨🪨🟨🌳🪨🪨🟨🌳🟨🟨🟨🟨🟨🪨🟨🪨🟨🪨🟨🪨🪨🪨🟨❎❎🟨🪨🪵🪨🪵🟨🪨❎❎❎❎🟨❎🟨❎❎🟨🟨🟨🟨🟨🟨❎🟨🟨❎🟨🟩🪵🟩🟨🟨🟨🟨🟩🟩❎🪨🟨❎🪨🟩🟩🏠🏠🏠
🏠🏠🏠🌿🟨🟨🪵🪵🟨🟨🟨🟨🟨🟨🟨🟨🟨🟨🟨❎🟨🟨🟨🪵❎🟨🟨❎🟨🪵🟨🟨🟨🪨🪨❎🪵❎🟨🟨🟨❎🟨🟨🟨🟨🟨🟨🪨🟨❎🟨🪨🪨🪨🟨🪨🟨🪨🪨🪨🟨❎🟨🟨🪨🪨🌳🟨❎🟨🪨🟨🪵❎🪨🟦🟦🟦🟦🟦🟦🟦🟨❎🟨🟩🟩🟨🌳🟨🟨🟨🟨🟩🟩🌳🟨🟩🟩🟩🟩🟩🏠🏠🏠
🏠🏠🏠🏠🟨🟨🟨🟨🟨🟨🟨🟨🌿🌿🌿🟨🟨🟨🌳🟨🟨🟨🟨🌳🪨🟨🟨🟨❎🟨🟨❎🟨🪨🪨❎🪵🟨🟨🌳🟨❎🟨🪵🪨🟨🪨🪨🟨🪨🟨❎❎🪨🪨🟨🪨❎🟨🟨🟨🟨🪨🪨🪨🟨❎🟨❎❎🟨❎❎🟨🟨❎🟦🟦🟦🟦🟦🟦🟦🟨🟨🟨🟩🟩🟩🟩🟨🟨🟨🪨🟩🟩🟩🟨🌳🟩🪨🟩🟩🏠🏠🏠
🏠🏠🏠🏠🌿🌿🟨🟨🟨🟨🏠🏠🏠🏠🏠🏠🟨🟨🟨🪨🪨🟨❎🟨🪵❎🟨🟨🟨❎🌳🟨🟨🟨🟨🟨🟨🪵🟨🟨🟨🟨🟨🟨🪨🟨🪨🪨🪨🟨🪨❎🟨🟨🪨🟨🪨🪨🟨🪨🟨❎🪨🟨❎❎🟨❎🟨🪵❎🟨❎🟨🪨🪨🟦🟦🟦🟦🟦🟦🟦🟦🟦🟦🟦🟩🟨🟨🟨🟨🟨🟨🟩🟩🟩🟩❎🟨🪵🟨🟩🏠🏠🏠
🏠🏠🏠🏠🏠🟨🟨🟨🟨🏠🏠🏠🏠🏠🏠🏠🏠🟨🪵🟨🟨🟨🟨🟨❎🟨🟨❎🟨🟨🟨🟨🟨❎🟨🪵🟨🟨🟨🟨🟨🟨🪵🟨🟨🟨🟨🪨🟨🪨🟨🪵🪨❎🟨🟨🪨🪨🟨🟨❎🟨🟨❎🪵🟨🟨🟨❎🪨🟨❎🪨❎🟨❎🟨🟦🟦🟦🟦🟦🟦🟦🟦🟦🟦🟦🟨🟨🟨🟨🟨🟨🪵🟩🟩❎❎🟨🟨🟨🟨🏠🏠🏠
🏠🏠🏠🏠🏠🟨🟨🟨🏠🏠🏠🏠🏠🏠🏠🏠🏠🌿🟨🟨❎🟨🌳🟨🟨🟨🪨🟨🟨🪵❎🟨❎🟨🟨🟨🟨❎🟨🟨🪨🟨🟨🟨🟨🪵🟨🟨❎🟨🪨🟨🟨🟨❎❎🟨🟨🪵❎🟨🟨🟨❎❎🟨❎❎🟨❎❎🌳🟨🪵🌳🟨🟨🟦🟦🟦🟦🟦🟦🟦🟦🟦🟦🟦🟦🟦🟦🟦🟨🟨🟨🟨🟨🟨🟨🟨🟨🌿🌿🏠🏠🏠
🏠🏠🏠🏠🏠🏠🟨🏠🏠🏠🏠🏠🏠🏠🏠🏠🏠🟨🟨🟨🪨🟨🟨🟨🟨🟨🟨🟨🟨❎🟨❎🟨❎❎🪵🟨🟨🟨🟨🟨🟨🟨🟨🟨🟨🟨🟨🟨❎🟨🟨🟨🟨🟨🟨❎🟨🟨🟨🟨🌳🟨🟨🟨🟨🟨❎🪨🟨🟨🟨❎❎🪨🟨🟦🟦🟦🟦🟦🟦🟦🟦🟦🟦🟦🟦🟦🟦🟦🟦🟨🟨🟨🟨🟨🟨🟦🟦🟦🟦🟦🏠🏠🏠
🏠🏠🏠🏠🏠🏠🟨🏠🏠🏠🏠🏠🏠🏠🏠🏠🏠🟨🟨🟨🟨❎❎🟨🟨🪵🪵🪵🟨🟨🟨🟨🟨🟨🟨🟨🟨🟨🟨🟨🟨🟨🟨🟨🟨🟨🟨🟨🟨🌿🌿🏠🟨🟨🏠🌿🌿🟨🟨🟨🟨🟨🟨🟨🟨🟨🟨❎🟨🟨🟨🟦🟦🟦🟦🟦🟦🟦🟦🟦🟦🟦🟦🟦🟦🟦🟦🟦🟦🟦🟦🟦🟦🟦🟦🟦🟦🟦🟦🟦🟦🟦🟦🟦🟦🟦
🏠🏠🏠🏠🏠🏠🟨🏠🏠🏠🏠🏠🏠🏠🏠🏠🏠🌿🌿🟨🟨🟨🟨🟨🟨❎🪵🟨🪵🟨🟨🟨🟨🟨🌿🌿🌿🟨🏠🟨🟨🟨🏠🏠🏠🏠🏠🏠🏠🏠🏠🏠🟨🟨🏠🏠🏠🏠🏠🏠🏠🏠🏠🏠🏠🏠🏠🏠🏠🏠🏠🟦🟦🟦🟦🟦🟦🟦🟦🟦🟦🟦🟦🟦🟦🟦🟦🟦🟦🟦🟦🟦🟦🟨🟨🟨🟦🟦🟦🟦🟦🟦🟦🟦🟦🟦
🏠🏠🏠🏠🏠🏠🟨🏠🏠🏠🏠🏠🏠🏠🏠🏠🏠🏠🟨🟨🟨🟨🟨🟨🟨🟨🟨🟨🟨🟨🟨🌿🏠🏠🏠🏠🏠🏠🏠🟨🟨🟨🏠🏠🏠🏠🏠🏠🏠🏠🏠🏠🟨🟨🏠🏠🏠🏠🏠🏠🏠🏠🏠🏠🏠🏠🏠🏠🏠🏠🏠🟦🟦🟦🟦🟦🟦🟦🟦🟦🟦🟦🟦🟦🟦🟦🟦🟦🟦🟦🟦🟦🟦🟨🟨🏠🟦🟦🟦🟦🟦🟦🟦🟦🟦🟦
🏠🏠🏠🏠🏠🏠🟨🏠🏠🏠🏠🏠🏠🏠🏠🏠🏠🏠🏠🟨🟨🟨🟨🟨🟨🟨🟨🟨🟨🟨🏠🏠🏠🏠🏠🏠🏠🏠🏠🟨🟨🟨🏠🏠🏠🏠🏠🏠🏠🏠🏠🏠🟨🟨🏠🏠🏠🏠🏠🏠🏠🏠🏠🏠🏠🏠🏠🏠🏠🏠🏠🟦🟦🟦🟦🟦🟦🟦🟦🟦🟦🏠🏠🟦🟦🟦🟦🟦🟦🟦🟦🟦🟦🟦🟦🟦🟦🟦🟦🟦🟦🟦🟦🟦🟦🟦
🏠🏠🏠🏠🏠🏠🟨🏠🏠🏠🏠🏠🏠🏠🏠🏠🏠🏠🏠🏠🏠🟨🟨🟨🟨🟨🟨🟨🟨🏠🏠🏠🏠🏠🏠🏠🏠🏠🏠🏠🏠🏠🏠🏠🏠🏠🏠🏠🏠🏠🏠🏠🟨🟨🏠🏠🏠🏠🏠🏠🏠🏠🏠🏠🏠🏠🏠🏠🏠🏠🏠🟦🟦🟦🟦🟦🟦🟦🟦🟦🟦🏠🏠🟦🟦🟦🟦🟦🟦🟦🟦🟦🟦🟦🟦🟦🟦🟦🟦🟦🟦🟦🟦🟦🟦🟦
🏠🏠🏠🏠🏠🏠🟨🏠🏠🏠🏠🏠🏠🏠🏠🏠🏠🏠🏠🏠🏠🏠🌿🌿🟨🟨🟨🟨🟨🏠🏠🏠🏠🏠🏠🏠🏠🏠🏠🏠🏠🏠🏠🏠🏠🏠🏠🏠🏠🏠🏠🏠🟨🟨🏠🏠🏠🏠🏠🏠🏠🏠🏠🏠🏠🏠🏠🏠🏠🏠🏠🏠🏠🟦🟦🟦🟦🟦🟦🟦🟦🟦🟦🟦🟦🟦🟦🟦🟦🟦🟦🟦🟦🟦🟦🟦🟦🟦🟦🟦🟦🟦🟦🟦🟦🟦
🏠🏠🏠🏠🏠🏠🟨🏠🏠🏠🏠🏠🏠🏠🏠🏠🏠🏠🏠🏠🏠🟨🟨🟨🟨🟨🟨🌿🌿🟨🏠🏠🏠🏠🏠🏠🏠🏠🏠🏠🏠🏠🏠🏠🏠🏠🏠🏠🟨🟨🟨🟨🟨🟨🟨🟨🟨🏠🏠🏠🏠🏠🏠🏠🏠🏠🏠🏠🏠🏠🏠🏠🏠🟦🟦🟦🟦🟦🟦🟦🟦🟦🟦🟦🟦🟦🟦🟦🟦🟦🟦🟦🟦🟦🟦🟦🟦🟦🟦🟦🟦🟦🟦🟦🟦🟦
🏠🏠🏠🏠🏠🟨🟨🟨🏠🏠🟨🏠🏠🏠🏠🏠🏠🏠🏠🏠🟨🟨🟨🟨🟨🟨🟨🟨🌿🟨🏠🏠🏠🏠🏠🏠🏠🏠🏠🏠🏠🏠🏠🏠🏠🏠🟨🟨🟨🟨🟨🪨🟨🟨🪨🪨🟨🟨🪨🟨🟨🟨🏠🏠🏠🏠🏠🏠🏠🏠🏠🏠🏠🟦🟦🟦🟦🟦🟦🟦🟦🟦🟦🟦🟦🟦🟦🟦🟦🟦🟦🟦🟦🟦🟦🟦🟦🟦🟦🟦🟦🟦🟦🟦🟦🟦
🏠🟨🌿🌿🌿🟨🟨🟨🟨🌿🌿🟨🟨🟨🟨🏠🏠🟨🌿🌿🌿🟨🟨🟨🟨🟨🟨🟨🟨🟨🟨🏠🏠🏠🏠🏠🏠🏠🏠🏠🏠🏠🏠🏠🏠🏠🟨🪨🪨🟨🟨🟨🟨🪨🟨🪨🪨🏠🟨🪨🪨🪨🟨🏠🏠🏠🏠🏠🏠🏠🏠🏠🏠🏠🟦🟦🟦🟦🟦🟦🟦🟦🟦🟦🟦🟦🟦🟦🟦🟦🟦🟦🟦🟦🟦🟦🟦🟦🟦🟦🟦🏠🏠🟦🏠🏠
🏠🟨🟨🟨🟨🟨🟨🟨🟨🟨🟨🟨🟨🌿🌿🏠🏠🟨🟨🟨🟨🟨🟨🟨🟨🟨🟨🪵🪵🟨🟨🏠🏠🏠🏠🏠🏠🏠🏠🏠🏠🏠🏠🏠🏠🏠🪨🪨🪨🟨🪨🪨🪨🟨🟨🟨🪨🟨🟨🪨🪨🟨🟨🏠🏠🏠🏠🏠🏠🏠🏠🏠🏠🏠🟦🟦🟦🟦🟦🟦🟦🟦🟦🟦🟦🟦🟦🟦🟦🟦🟦🟦🟦🟦🟦🟦🟦🟦🟦🟦🏠🏠🏠🟦🟦🟦
🏠🟨🟨🪵🪵🟨🟨🟨🟨🟨🟨🟨🟨🟨🟨🟨🟨🌿🟨🟨🟨🟨🟨🟨🟨🟨🟨🪵🪵🟨🟨🏠🏠🏠🏠🏠🏠🏠🏠🏠🏠🏠🏠🏠🏠🏠🟨🟨🟨🪨🟨🪨🪨🪨🟨🟨🟨🪨🪨🪨🪨🟨🪨🏠🏠🏠🏠🏠🏠🏠🏠🏠🏠🏠🏠🏠🏠🟦🟦🟦🟦🟦🟦🟦🟦🟦🟦🟦🟦🟦🟦🟦🟦🟦🟦🟦🟦🟦🟦🟦🟦🏠🏠🏠🏠🏠
🏠🟨🟨🪵🪵🟨🟨🟨🟨🟨🟨🟨🟨🟨🟨🟨🟨🟨🟨🟨🟨🟨🟨🟨🟨🟨🟨🟨🟨🟨🟨🏠🏠🏠🏠🏠🏠🏠🏠🏠🏠🏠🏠🏠🌿🟨🟨🪨🟨🟨🪨🟨🪨🪨🪨🟨🪨🟨🪨🟨🪨🟨🟨🟨🟨🟨🟨🟨🏠🏠🏠🏠🏠🏠🏠🏠🏠🏠🟦🟦🟦🟦🟦🟦🟦🟦🟦🟦🟦🟦🟦🟦🟦🟦🟦🟦🟦🟦🟦🟦🟦🟦🟦🟦🟦🟦
🏠🟨🟨🟨🟨🟨🟨🟨🟨🟨🟨🟨🟨🟨🟨🪵🪵🟨🟨🟨🟨🟨🟨🟨🟨🟨🟨🟨🟨🟨🟨🏠🏠🏠🏠🏠🏠🏠🏠🏠🏠🏠🏠🏠🟨🟨🟨🟨🪨🪨🟨🟨🪨🟨🪨🟨🟨🪨🟨🪨🪨🏠🟨🟨🪨🪨🪨🪨🟨🏠🏠🏠🏠🏠🏠🏠🏠🏠🟦🟦🟦🟦🟦🟦🟦🟦🟦🟦🟦🟦🟦🟦🟦🟦🟦🟦🟦🟦🟦🟦🟦🟦🟦🟦🟦🟦
🏠🌿🟨🟨🟨🟨🟨🟨🟨🌿🟨🟨🟨🟨🟨🪵🪵🟨🟨🟨🟨🟨🟨🟨🟨🟨🟨🟨🟨🟨🟨🏠🏠🏠🏠🏠🏠🏠🏠🏠🏠🏠🏠🏠🏠🟨🟨🟨🪨🪨🟨🪨🟨🟨🪨🪨🟨🟨🟨🪨🪨🟨🪨🟨🟨🪨🪨🪨🟨🏠🏠🏠🏠🏠🏠🏠🏠🏠🟦🟦🟦🟦🟦🟦🟦🟦🟦🟦🟦🟦🟦🟦🟦🟦🟦🟦🟦🟦🟦🟦🟦🟦🟦🟦🟦🟦
🏠🟨🟨🟨🟨🟨🟨🟨🟨🟨🟨🟨🟨🟨🟨🟨🟨🟨🟨🟨🟨🟨🟨🟨🟨🟨🟨🟨🟨🟨🟨🏠🏠🏠🏠🏠🏠🏠🏠🏠🏠🏠🏠🏠🏠🏠🏠🪨🪨🪨🪨🟨🪨🟨🪨🪨🪨🟨🟨🪨🟨🟨🟨🪨🪨🟨🟨🪨🟨🏠🏠🏠🏠🏠🏠🏠🏠🏠🟦🟦🟦🟦🟦🟦🟦🟦🟦🟦🟦🟦🟦🟦🟦🟦🟦🟦🟦🟦🟦🟦🟦🟦🟦🟦🟦🟦
🏠🏠🟨🟨🟨🟨🌿🌿🟨🟨🟨🟨🟨🟨🌿🌿🟨🟨🟨🟨🌿🟨🟨🏠🏠🟨🟨🟨🟨🟨🟨🏠🏠🏠🏠🏠🏠🏠🏠🏠🏠🏠🏠🏠🏠🏠🏠🟨🪨🟨🟨🪨🟨🪨🪨🟨🪨🟨🟨🟨🟨🟨🟨🟨🟨🟨🟨🟨🟨🏠🏠🏠🏠🏠🏠🏠🏠🏠🟦🟦🟦🟦🟦🟦🟦🏠🏠🟦🟦🟦🟦🟦🟦🟦🟦🟦🟦🟦🟦🟦🟦🟦🟦🟦🟦🟦
🏠🏠🟨🟨🟨🟨🟨🟨🟨🟨🪵🪵🟨🟨🟨🟨🟨🟨🟨🟨🟨🟨🟨🏠🏠🟨🟨🟨🟨🌿🌿🏠🏠🏠🏠🏠🏠🏠🏠🏠🏠🏠🏠🏠🏠🏠🏠🏠🏠🟨🟨🟨🟨🟨🟨🟨🪨🪨🪨🟨🟨🟨🟨🪨🪨🪨🪨🪨🟨🏠🏠🏠🏠🏠🏠🏠🏠🏠🟦🟦🟦🟦🟦🟦🟦🏠🏠🏠🟦🏠🟦🟦🟦🟦🟦🟦🟦🟦🟦🟦🟦🟦🟦🟦🟦🟦
🏠🏠🏠🟨🟨🟨🟨🟨🟨🟨🪵🪵🟨🟨🟨🟨🟨🟨🟨🟨🟨🟨🟨🟨🟨🟨🪵🪵🟨🟨🟨🏠🏠🏠🏠🏠🏠🏠🏠🏠🏠🏠🏠🏠🏠🏠🏠🏠🏠🏠🏠🏠🏠🏠🪨🪨🟨🪨🪨🪨🟨🪨🪨🪨🟨🪨🪨🟨🟨🏠🏠🏠🏠🏠🏠🏠🏠🏠🏠🟦🟦🟦🟦🟦🟦🟦🟦🟦🟦🟦🟦🟦🟦🟦🟦🟦🟦🟦🟦🟦🟦🟦🟦🟦🟦🟦
🏠🏠🏠🟨🟨🟨🟨🟨🟨🟨🟨🟨🟨🟨🟨🟨🟨🪵🪵🟨🟨🟨🟨🟨🟨🟨🪵🪵🟨🟨🏠🏠🏠🏠🏠🏠🏠🏠🏠🏠🏠🏠🏠🏠🏠🏠🏠🏠🏠🏠🏠🏠🏠🏠🏠🪨🪨🟨🟨🪨🟨🪨🪨🟨🪨🪨🟨🪨🟨🏠🏠🏠🏠🏠🏠🏠🏠🏠🏠🟦🟦🟦🟦🟦🟦🟦🟦🟦🟦🟦🟦🟦🟦🟦🏠🏠🟦🟦🟦🟦🟦🟦🟦🟦🟦🟦
🏠🏠🏠🏠🟨🟨🟨🟨🟨🟨🟨🟨🟨🟨🟨🟨🟨🪵🪵🟨🟨🌿🌿🟨🟨🟨🟨🟨🟨🟨🏠🏠🏠🏠🏠🏠🏠🏠🏠🏠🏠🏠🏠🏠🏠🏠🏠🏠🏠🏠🏠🏠🏠🏠🏠🟨🪨🟨🟨🟨🟨🟨🪨🟨🟨🟨🟨🟨🟨🏠🏠🏠🏠🏠🏠🏠🏠🏠🏠🟦🟦🟦🟦🟦🟦🟦🟦🟦🟦🟦🟦🟦🟦🟦🏠🏠🟦🟦🟦🟦🟦🟦🟦🟦🟦🟦
🏠🏠🏠🏠🟨🌿🌿🟨🟨🟨🪵🪵🟨🟨🟨🟨🟨🟨🟨🟨🟨🟨🟨🟨🟨🟨🟨🟨🟨🏠🏠🏠🏠🏠🏠🏠🏠🏠🏠🏠🏠🏠🏠🏠🏠🏠🏠🏠🏠🏠🏠🏠🏠🏠🏠🏠🟨🟨🟨🟨🟨🟨🟨🟨🟨🟨🟨🟨🏠🏠🏠🏠🏠🏠🏠🏠🏠🏠🏠🟦🟦🟦🟦🟦🟦🟦🟦🟦🟦🟦🟦🟦🟦🟦🟦🟦🟦🟦🟦🟦🟦🟦🟦🟦🟦🟦
🏠🏠🏠🏠🏠🏠🏠🟨🟨🏠🪵🪵🟨🌿🌿🟨🟨🟨🟨🟨🟨🟨🟨🟨🟨🟨🟨🌿🏠🏠🏠🏠🏠🏠🏠🏠🏠🏠🏠🏠🏠🏠🏠🏠🏠🏠🏠🏠🏠🏠🏠🏠🏠🏠🏠🏠🏠🏠🏠🏠🏠🏠🏠🏠🏠🏠🏠🏠🏠🏠🏠🏠🏠🏠🏠🏠🏠🏠🏠🟦🟦🟦🟦🟦🟦🟦🟦🟦🟦🟦🟦🟦🟦🟦🟦🟦🟦🟦🟦🟦🟦🟦🟦🟦🟦🟦
🏠🏠🏠🏠🏠🏠🏠🏠🏠🟨🟨🟨🌿🏠🏠🏠🏠🌿🌿🌿🟨🟨🏠🏠🏠🏠🏠🏠🏠🏠🏠🏠🏠🏠🏠🏠🏠🏠🏠🏠🏠🏠🏠🏠🏠🏠🏠🏠🏠🏠🏠🏠🏠🏠🏠🏠🏠🏠🏠🏠🏠🏠🏠🏠🏠🏠🏠🏠🏠🏠🏠🏠🏠🏠🏠🏠🏠🏠🏠🟦🟦🟦🟦🟦🟦🟦🟦🟦🟦🟦🟦🟦🟦🟦🟦🟦🟦🟦🟦🟦🟦🟦🟦🟦🟦🟦
🏠🏠🏠🏠🏠🏠🏠🏠🏠🏠🟨🟨🏠🏠🏠🏠🏠🏠🏠🏠🏠🏠🏠🏠🏠🏠🏠🏠🏠🏠🏠🏠🏠🏠🏠🏠🏠🏠🏠🏠🏠🏠🏠🏠🏠🏠🏠🏠🏠🏠🏠🏠🏠🏠🏠🏠🏠🏠🏠🏠🏠🏠🏠🏠🏠🏠🏠🏠🏠🏠🏠🏠🏠🏠🏠🏠🏠🏠🏠🟦🟦🟦🟦🟦🟦🟦🟦🟦🟦🟦🟦🟦🟦🟦🟦🟦🟦🟦🟦🟦🟦🟦🟦🟦🟦🟦