🟦🟦🟦🟦🟦🟦🟦🟦🟦🟦🟦🟦🟦🟦🟦🟦🟦🟦🟦🟦🟦🟦🟦🟦🟨🟨🟨🟨🟨🟨🟨🟨🟨🟨🟨🟨🟨🟨🟨🟨🟨🟨🟨🟨🟨🟨🟨🟨🟨🟨🟨🟨🟨🟨🟨🟨🟨🟨🟨🟨🟨🟨🟨🟨🟨🟨🟨🟨🟨🟨🟨🟨🟨🟨🟨🟨🟨🟨🟨🟨🟨🟨🟨🟨🟨🟨🟨🟨🟨🟨🟨🟨🟨🟨🟨🟨🟨🟨🟨🟨🟨🟨🟨🟨🟨
🟦🟦🟦🟦🟦🟦🟦🟦🟦🟦🟦🟦🟦🟦🟦🟦🟦🟦🟦🟦🟦🟦🟦🟦🟨🟨🟨🟨🟨🟨🟨🟨🟨🟨🟨🟨🟨🟨🟨🟨🟨🟨🟨🟨🟨🟨🟨🟨🟨🟨🟨🟨🟨🟨🟨🟨🟨🟨🟨🟨🟨🟨🟨🟨🟨🟨🟨🟨🟨🟨🟨🟨🟨🟨🟨🟨🟨🟨🟨🟨🟨🟨🟨🟨🟨🟨🟨🟨🟨🟨🟨🟨🟨🟨🟨🟨🟨🟨🟨🟨🟨🟨🟨🟨🟨
🟦🟦🟦🟦🟦🟦🟨🟨🟨🟦🟦🟦🟦🟦🟦🟦🟦🟦🟦🟦🟦🟦🟦🟦🟨🟨🟨🟨🟨🟨🟨🟨🟨🟨🟨🟨🟨🟨🟨🟨🟨🟨🟨🟨🟨🟨🟨🟨🟨🟨🟨🟨🟨🟨🟨🟨🟨🟨🟨🟨🟨🟨🟨🟨🟨🟨🟨🟨🟨🟨🟨🟨🟨🟨🟨🟨🟨🟨🟨🟨🟨🟨🟨🟨🟨🟨🟨🟨🟨🟨🟨🟨🟨🟨🟨🟨🟨🟨🟨🟨🟨🟨🟨🟨🟨
🟦🟦🟦🟦🟦🟦🟦🟦🟦🟦🟦🟦🟦🟦🟦🟦🟦🟦🟦🟦🟦🟦🟦🟦🟨🟨🟨🟨🟨🟨🟨🟨🟨🟨🟨🟨🟨🟨🟨🟨🟨🟨🟨🟨🟨🟨🟨🟨🟨🟨🟨🟨🟨🟨🟨🟨🟨🟨🟨🟨🟨🟨🟨🟨🟨🟨🟨🟨🟨🟨🟨🟨🟨🟨🟨🟨🟨🟨🟨🟨🟨🟨🟨🟨🟨🟨🟨🟨🟨🟨🟨🟨🟨🟨🟨🟨🟨🟨🟨🟨🟨🟨🟨🟨🟨
🟦🟦🟦🟦🟨🟨🟨🟨🟨🟨🟦🟦🟦🟦🟦🟦🟦🟦🟦🟦🟦🟦🟦🟦🟨🟨🟨🟨🟨🟨🟨🟨🟨🟨🟨🟨🟨🟨🟨🟨🟨🟨🟨🟨🟨🟨🟨🟨🟨🟨🟨🟨🟨🟨🟨🟨🟨🟨🟨🟨🟨🟨🟨🟨🟨🟨🟨🟨🟨🟨🟨🟨🟨🟨🟨🟨🟨🟨🟨🟨🟨🟨🟨🟨🟨🟨🟨🟨🟨🟨🟨🟨🟨🟨🟨🟨🟨🟨🟨🟨🟨🟨🟨🟨🟨
🟦🟦🟦🟦🟨🟨🟨🟨🟨🟨🟨🟦🟦🟦🟨🟨🟨🟨🟦🟦🟦🟦🟦🟦🟨🟨🟨🟨🟨🟨🟨🟨🟨🟨🟨🟨🟨🟨🟨🟨🟨🟨🟨🟨🟨🟨🟨🟨🟨🟨🟨🟨🟨🟨🟨🟨🟨🟨🟨🟨🟨🟨🟨🟨🟨🟨🟨🟨🟨🟨🟨🟨🟨🟨🟨🟨🟨🟨🟨🟨🟨🟨🟨🟨🟨🟨🟨🟨🟨🟨🟨🟨🟨🟨🟨🟨🟨🟨🟨🟨🟨🟨🟨🟨🟨
🟨🟦🟦🟦🟨🟨🟨🟨🟨🟨🟨🟦🟦🟦🟨🟨🟨🟨🟦🟦🟦🟨🟨🟨🟨🟨🟨🟨🟨🟨🟨🟨🟨🟨🟨🟨🟨🟨🟨🟨🟨🟨🟨🟨🟨🟨🟨🟨🟨🟨🟨🟨🟨🟨🟨🟨🟨🟨🟨🟨🟨🟨🟨🟨🟨🟨🟨🟨🟨🟨🟨🟨🟨🟨🟨🟨🟨🟨🟨🟨🟨🟨🟨🟨🟨🟨🟨🟨🟨🟨🟨🟨🟨🟨🟨🟨🟨🟨🟨🟨🟨🟨🟨🟨🟨
🟨🟦🟦🟦🟨🟨🟨🟨🟨🟨🟨🟦🟦🟦🟨🟨🟨🟦🟦🟦🪵🟨🟨🟨🟨🟨🟨🟨🟨🟨🟨🟨🟨🟨🟨🟨🟨🪨🪵🟨🟨🪵🪨🟨❎❎🟨❎🟨🟨🟨🟨🟨🟨🟨🟨🟨🟨🟨🟨🟨🟨🟨🟨🟨🟨🟨🟨🟨🟨🟨🟨🟨🚫🟨🟨🚫🚫🚫🟨🟨🟨🟨🟨🟨🟨🟨🟨🟨🟨🟨🟨🟨🟨🟨🟨🟨🟨🟨🟨🟨🟨🟨🟨🟨
🟨🟦🟦🟦🟨🟨🟨🟨🟨🟨🟨🟦🟦🟦🟦🟦🟦🟦🟦🟦🟨🌳🟨🟨🟨🟨🟨🟨🟨🟨🟨🟨🟨🪨🟨🟨🟨🪨🟨🟨🟨🪨🟨🟨🟨🟨🟨🟨🟨🪨🟨🟨🟨🟨🟨🟨🟨🟨🟨🟨🟨🟨🟨🟨🟨🟨🟨🟨🟨🟨🟨🟨🚫🟨🚫🚫🟨🟨🟨🚫🟨🟨🟨🟨🟨🟨🟨🟨🟨🟨🟨🟨🟨🟨🟨🟨🟨🟨🟨🟨🟨🟨🟨🟨🟨
🟦🟦🟦🟦🟨🟨🟨🟨🟨🟨🟨🟦🟦🟦🟦🟦🟦🟦🟦🟦🟨🟨🟨🟨🟨🟨🟨🟨🟨🟨🟨🟨🟨🟨🟨🌳🟨🟨🟩🟨🟨🟨🪨🟨🌳🟨🪨🟨🪵🟨🟨🟨🟨🟨🟨🟨🟨🟨🟨🟨🟨🟨🟨🟨🟨🟨🟨🟨🟨🟨🟨🚫🟨🟨🚫🚫🟨🟨🟨🟨🚫🟨🟨🟨🟨🟨🟨🟨🟨🟨🟨🟨🟨🟨🟨🟨🟨🟨🟨🟨🟨🟨🟨🟨🟨
🟦🟦🟦🟦🟦🟨🟨🟨🟨🟨🟨🟦🟦🟦🟦🟦🟦🟦🟦🟨🟨🟨🟨🟨🟨🟨🟨🟨🟨🟨🟨🟨🟨🟨🟨🟨🟨🟨🟨🟨🟨🟨🟨🟨🟨🟨🟨🌳🟨🟨🟨🟨🟨🟨🟨🟨🟨🟨🚫🚫🚫🚫🟨🟨🟨🟨🟨🟨🟨❌🤖🟨🟨🟨🟨🟨🟨🟨🟨🟨🚫🟨🟨🟨🟨🟨🟨🟨🟨🟨🟨🟨🟨🟨🟨🟨🟨🟨🟨🟨🟨🟨🟨🟨🟨
🟦🟦🟦🟦🟦🟦🟦🟦🟦🟦🟦🟦🟦🟦🟦🟦🟦🟦🟦🪨🟨🟨🟨🟨🟨🟨🟨🟨🟨🟨🟨🟨🟨🟨🟨🪵🟨🟨🟨🪵🪵🟨🟨🟨🟨❎🟨🪵🟨🟨🟨🟨🟨🪨🟨🟨🟨🟨🚫🟨🟨🟨🟨🟨🟨🟨🟨🟨🟨🟨🟨🟨🟨🟨🟨🟨🟨🟨🟨🚫🚫🟨🟨🟨🟨🟨🟨🟨🟨🟨🟨🟨🟨🟨🟨🟨🟨🟨🟨🟨🟨🟨🟨🟨🟨
🟦🟦🟦🟦🟦🟦🟦🟦🟦🟦🟦🟦🟦🟦🟦🟦🟦🟦🟦🟨🟨🪨🟨🟨🟨🟨🟨🟨🟨🟨🟨🟨🟨🟨🟨❎🟨❎🟨🪵🪵🪵🟨🟨🪨🟨❎🟩🟨🟨🟨🌳🟨🟨🟨🟨🟨🟨🚫🟨🟨🟨🟨🟨🟨🟨🟨🟨🟨🟨🟨🟨🟨🟨🟨🟨🟨🟨🟨🟨🟨🚫🟨🟨🟨🟨🟨🟨🟨🟨🟨🟨🟨🟨🟨🟨🟨🟨🟨🟨🟨🟨🟨🟨🟨
🟦🟦🟦🟦🟦🟦🟦🟦🟦🟦🟦🟦🟦🟦🟦🟦🟦🟦🟦🟦🟨🪨🟨🟨🟨🟨🟨🟨🟨🟨🟨🟨🟨🟨🟨🟨🟨🟨❎🟨❎🟨🟨🟨❎🟩🟩🟩🟩🟩🪵🟨❎🟨🟨🟨🌳🟨🚫🟨🟨🟨🟨🟨🟨🟨🟨🟨🟨🟨🟨🟨🟨🟨🟨🟨🟨🟨🟨🟨🟨🚫🟨🟨🟨🟨🟨🟨🟨🟨🟨🟨🟨🟨🟨🟨🟨🟨🟨🟨🟨🟨🟨🟨🟨
🟦🟦🟦🟦🟦🟦🟦🟦🟦🟦🟦🟦🟦🟦🟨🟨🟦🟦🟦🟦🟨🟨🟨🟨🟨🟨🟨🟨🟨🟨🟨🟨🟨🟨🟨❎🪵🟨🟨❎🟨❎🌳❎🟨🟩🟩🟩🟩🟩🟨🪵🟨🟨🟨🟨🟨🟨🚫🟨🟨🟨🟨🟨🟨🟨🟨🟨🟨🟨🟨🟨🟨🟨🟨🟨🟨🟨🚫🚫🚫🟨🟨🟨🟨🟨🟨🟨🟨🟨🟨🟨🟨🟨🟨🟨🟨🟨🟨🟨🟨🟨🟨🟨🟨
🟦🟦🟦🟦🟦🟦🟦🟦🟦🟨🟨🟨🟨🟨🟨🟨🟦🟦🟦🟦🟨🟨🟨🟨🟨🟨🟨🟨🟨🟨🟨🟨🟨🟨❎❎🟨🪨🟨🟨❎🟨🟨🟨🟨🟩🟩🟩🟩🟨🟨🟨🟨🟨🟨🟨🟨🟨🚫🟨🟨🟨🚫🟨🟨🟨🟨🟨🟨🟨🟨🟨🟨🟨🟨🟨🟨🟨🚫🟨🟨🟨🟨🟨🟨🟨🟨🟨🟨🟨🟨🟨🟨🟨🟨🟨🟨🟨🟨🟨🟨🟨🟨🟨🟨
🟦🟦🟦🟦🟦🟦🟦🟦🟦🟨🟨🟨🟨🟨🟨🟨🟦🟦🟦🟦🟨🟨🟨🪵🟨🟨🟨🟨🟨🟨🟨🟨🟨🟨🪨🌳❎🟨❎❎🟨❎🪵🟨🌳🟩🟩🟩🟩🟨🪨🟨🟨🟨🪨🟨🟨🟨🟨🌳🟨🚫🟨🟨🟨🟨🟨🟨🟨🟨🟨🟨🟨🟨🟨🟨🟨🟨🚫🟨🟨🟨🟨🟨🟨🟨🟨🟨🟨🟨🟨🟨🟨🟨🟨🟨🟨🟨🟨🟨🟨🟨🟨🟨🟨
🟦🟨🟨🟨🟨🟦🟦🟦🟦🟦🟨🟨🟨🟨🟨🟦🟦🟦🟦🟦🟨🟨🟨🟨🟨🟨🟨🟨🟨🟨❎🟨🪨🟨🌳🟨❎🟨🟨❎🌳🟨🟨🟨🟨🟩🟩🟩🟩🟩🟨🟨🟨🟨🟨🟨🟨🟨🟨🟨🟨🟨🟨🟨🟨🟨🟨🟨🟨🟨🟨🟨🟨🟨🟨🟨🟨🟨🚫🟨🟨🟨🟨🟨🟨🟨🟨🟨🟨🟨🟨🟨🟨🟨🟨🟨🟨🟨🟨🟨🟨🟨🟨🟨🟨
🟦🟨🟨🟨🟨🟦🟦🟦🟦🟦🟦🟦🟦🟦🟦🟦🟦🟦🟦🟦🟨🟨🟨🌳🟨🪵🟨🟨🪨🟨🟨🪵❎🟨🟨🪨🪵🪵🟨🪨❎🟨❎🟨❎🟩🟩🟩🟩🟨🟨🟨🟨🪨🟨🟨🟨🟨🟨🟨🟨🟨🟨🌱🌱🌱🌱🌱🌱🌱🌱🌱🌱🟨🟨🟨🚫🚫🟨🟨🟨🟨🟨🟨🟨🟨🟨🟨🟨🟨🟨🟨🟨🟨🟨🟨🟨🟨🟨🟨🟨🟨🟨🟨🟨
🟦🟦🟨🟨🟦🟦🟦🟦🟦🟦🟦🟨🟨🟨🟦🟦🟦🟦🟦🟦🌳🟨🟨🟨🟨🟨🟨🟨🟩❎🟩❎🪨🟨🟨🪵🪵🪵❎🟨🟨🟨🪨🟨🟨🪨🪵🟩🌳🟨🟨🟨🪵🟨❎🟨🟨🪨🟨🪵🟨🟨🟨🟨🌱🌱🌱🌱🌱🌱🌱🌱🟨🟨🟨🟨🚫🟨🟨🟨🟨🪵🟩🟩🟩🟩🟩🟩🟩🟩🟩🟩🟨🟨🟩🟩🟩🟩🟩🟩🟩🟩🟩🟨🟨
🟦🟦🟦🟦🟦🟦🟦🟦🟦🟦🟦🟨🟨🟨🟦🟦🟦🟦🟦🟨🟨🟨🪨🪨❎🟨🪨🪵🟩🟩🟩🟩🟩🟩❎❎🟨🟨❎❎🟨🟨🟨❎🟨❎❎🟨🟨🟨❎❎🪵🟨🟨🟩🟩🟩🪨🟨🟨🟨🟨🌱🌱🌱🌱🌱🌱🌱🌱🌱🟨🟨🟨🟨🚫🟨🟨🟨🌱🪨🟩❎🟩🟩🟩🟩🟩🟩🟩🟩🪵🌳🟩🟩🟩🟩🟩🟩🟩🟩🟩🟨🟨
🟦🟦🟦🟦🟦🟦🟦🟦🟦🟦🟦🟦🟦🟦🟦🟦🟦🟦🟦🟨❎❎🟨🟨🪵🟨🟩🟩🟩🟩🟩🟩🟩🟩🟩🟨❎🟨🟨🪨🟨🌳🟨🪨🪵🟨🟨🪨🟨🟨🟨❎🟨❎🟨🟩🟩🟩🟩🌳🪨🟨🟨🌱🌱🌱🌱🌱🌱🌱🌱🌱🟨🟨🟨📦🟨🟨🟨🟨🪨🌱🟩🟩🟩🟩🟩🟩🟩❎🟨❎🟨🟩🟩🟩🟩🟩🟩🟩🟩🟩🟩🟨🟨
🟦🟦🟦🟦🟦🟦🟦🟦🟦🟦🟦🟦🟦🟦🟦🟦🟦🟦🟦🟨🟨🟨🟨🪨🟨🟨🟩🟩🟩🪵🟩🟩🪨🟩🟩🟨🟨🟨❎🟨🟨🟨🟨🪨❎🟨❎❎❎🪨🟨🌳🪨🟨❎🟩🟩🟩🟩🟩🟨🌳🟨🟨🌱🌱🌱🌱🌱🌱🌱🌱🟨🟨🟨🟨🚫🟨🟨🟨🌱🟨🟩🟨🟩🌳🟨🪵🟩🟨🟨🟨🪵🟨🟩❎🟩🟩🟩🟩🟩🟩🟩🟨🟨
🟦🟦🟦🟦🟦🟦🟦🟦🟦🟦🟦🟦🟦🟦🟦🟦🟦🟦🟨❎🟨🟨🟨🪨🟨🟩🟩🟩🟩🟩🟩🟩🟩🟩🟩🟩🟨🟨🟨❎🪨🪵❎🟨🟨🟨🟨❎🟨🪵🟨🪵🟨🟨🟩🟩🟩🟩🟩❎🪨🟨🟨🟨🌱🌱🌱🌱🌱🌱🌱🌱🟨🟨🟨🟨🚫🟨🟨🟨🌱🪨🟩🟩🟩🟩🪨🪨🪵🪨🪵🟨🪨🟨❎🟨🟨❎❎🟩🟩🟩🟨🟨🟨
🟦🟦🟦🟦🟦🟦🟦🟦🟦🟦🟦🟦🟦🟦🟦🟦🟦🟦🟨❎🪵🪨🟨🟨🟨🌳🟩🟩🟩🟩🟩🟩🟩🟩🟩🟩❎🟨🌳🌳🟨🟨🟨❎🟨🌳🪵🌳❎🌳🟨🟨❎🪨🟨🟩🟩🟩❎🟨🪵🟨🟨🌱🌱🌱🌱🌱🌱🌱🌱🌱🟨🟨🟨🟨🚫🟨🟨🟨🌱🟨🟨❎🟨🟩🟩❎🪨🟨🪨🟨🪵🪨🟨🟨🟨🪨🟩🟩🟩🌳🟨🟨🟨
🟦🟦🟦🟦🟦🟦🟦🟦🟦🟦🟦🟦🟦🟦🟦🟦🟦🟦🟨❎🟨🟨🟨🟨🟨🟩🟩🟩🪨🟩🟩🟩🪵🟩🟩🟩🟨❎🟨🪨🟨🪨🟨❎🟨🟨🟨🟨🪨🌳🌳🟨🟨🟨❎🟨❎❎🟨🪨❎❎🟨🪨🟨🟨🟨🟨🟨🟨🟨🟨🌱🌱🌱🌱🌱🌱🌱🌱🌱🟨🟨🟨❎🟨🟩🟨🪨❎🪵🟨🟨🪨❎❎🟨❎❎🟨🪵🪵🟨🟨🟨
🟦🟦🟦🟦🟦🟦🟦🟦🟦🟦🟦🟦🟦🟦🟦🟦🟦🟦🟦🟨🟨🪨❎🟨🟨❎🟩🟩🟩🟩🟩🟩🟩🟩🟩🟩🟩🟨🟨🟨🟨🟨🌳🪨🟨🟨❎🟨🟨❎🟨🟨❎🌳🟨❎🟨❎🟨🟨❎🟨🟨🟨🟨🟨🟨🟨🟨🟨❎🟨🟨🟨🟨🟨🟨🟨🟨🟨🟨🟨🟨🟨🟨🟨🟨🟨🟨🟩🟩🟨❎🟨🟨🪵❎🟨🟨❎🟨❎🟨🟨🟨
🟨🟨🟨🟨🟨🟨🟦🟦🟦🟦🟦🟦🟦🟦🟦🟦🟦🟦🟦🟨🪵🟨🟨🟨❎🟨🪵🟩🟩🟩🟩🟩🟩🟩🟩🟩❎🟨🪵🟨❎🟨🟨🟨🪨🟨🌳🌳🟨🟨🟨🪨🟨❎❎🟨🟨🟨🟨❎🟨❎🟨🟨🪵🪨🟨🟨🟨🟨🟨🟨🟨🟨🟨🟨🟨🟨🟨🟨🟨❎🟨🪨🪨🟨🟨🟨🟨🟨🟩🟨🟩🟩❎🪨🟨❎🪨🪵🪵🟨🟨🟨🟨
🟨🟨🟨🟨🟨🟨🟨🟦🟦🟦🟦🟦🟦🟦🟦🟦🟦🟦🟦🟨🪨❎🌳🟨🟨❎🟨🟨🟨🟩🟩🟩🟩🪨❎🟨🌳🟨✨🟨❎🟨🪨❎🟨❎🟨🟨❎❎🪵🟨🟨🌳🟨🟨🪵🟨❎🟨🟨🟨🌳🪨🟨🟨🟨🟨❎🟨🟨🌳🟨🟨🌳🟨🟨🟩🟩🟩🟨❎🟨🟨🟨🟨🟨🟨🟨🟨🟩🟩🟩🟩🟩🪵🟨🟨🟨🪵🪵🌳🟨🟨🟨
🟨🟨🟨🟨🟨🟨🟨🟨🟦🟦🟦🟦🟦🟦🟦🟦🟦🟦❎🪵🟨🟨🟨🟨🟨🟨🟨❎🪨🟨❎🟩🟨🟨🟨❎🟨🟨❎🟨🌳🟨🟨🟨🌳🪨🟨❎❎🟨🟨❎🪨🟨🟨🌳🟨🪨🟨🟨🌳🟨🟨🟨🟨🟨🟨🟨🟨🟨🟨🟨🪨🪵🟨🟨🟨🟩🟩🟩🟨❎🟨🟨🟨🟨🟨🟨🟨🟨🟨🟩🟩🟩🟩🟨❎❎🪵🪨🟩🟩🟩🟨🟨
🟨🟨🟨🟨🟨🟨🟨🟨🟨🟨🟦🟦🟦🟦🟦🟦🌳🟨🟨❎🪨❎🟨🟨🌳🟨🪵🟨❎🟨🪵🟨❎🌳🟨🟨🟨❎❎❎🟨🟨❎🟨🟨🟨🟨🟨❎🟨🟨🪨🌳🟨🟨🪨🟨🟨🟨❎🟨🪨🟨🟨🟨🟨🟨🟨🟨🟨🟨🟨🟨🟨🟨🟨🟨🟩🟩🟨🌳🟨🌳🟨🟨🟨🟨🟨🟨🟨🟨🟩🟩🟩🟩🟩🪨❎🟨🪨🟩🟩🟨🟨🟨
🟨🟨🟨🟨🟨🟨🟨🟨🟨🟨🟨🟨🟨🟨🟨🟨🟨🟨🪨🟨🟨🟨🟨🟨🟨🟨🪨🟨🟨🟨🟨🟨🟨🟨🟨🪵🪵🌳🟨🟨🪵🟨🟨🟨❎❎🪵🟨🟨🟨❎🟨🟨❎🟨🪨🟨🌳❎🟨🟨🪵🟨🪵🟨🟨🟨❎🟨🟨🟨🟨🪨🟨🟨🟨🟨🟨❎🪨🟨🟨🟨🟨🟨🟨🟨🟨🟨🟩🌳❎🟩🟩🟩🟩🟩❎🪨🪨🟩🟩🟩🟨🟨
🟨🟨🟨🟨🟨🟨🟨🟨🟨🟨🟨🟨🟨🟨🟨🟨🟨🟨🟨❎🟨🪨🟨🪵🟨🟨🟨🌳🌳🪵❎🟨🟨❎🟨🪵🪵🟨❎🟨🟨🌳🌳🟨🟨❎🟨🟨🌳🟨🟨🟨🪨❎🪵🟨🟨❎🟨🟨🟨🟨🟨🟨🟨🟨🪨🟨🌳❎🟨🪨❎🟨❎🪨🟨🟩🟩🟨🟨🪨🟨🟨🟨🟨🟨🪨🟨🟩🟩🟩🟩🟩🟩🟩🌳🟨🟨🟨🟩🟩🟩🟨🟨
🟨🟨🟨🟨🟨🟨🟨🟨🟨🟨🟨🟨🟨🟨🟨🟨🟨🪨🟨🪨🟨🟨❎🟨🟨🪨🟨🪨🟨🟨🟨🪨🟨❎🪵❎🌳🟨🟨🟨❎🟨🟨🟨🪨🟨❎🟨🟨❎🪨🪵🟨🟨🟨🟨❎🟨🟨🟨🪨🟨🟨🌳🪨🟨🟨❎🟨🟨❎❎🟨❎🟨🟨🟨🟩🟩🟩🪨❎❎🟨🟨🟨🟨🪵🟩🟨🟩🟩🟩🟩🟩🟩🟩🟩🌳🟨🟩🟨🟩🟨🟨
🟨🟨🟨🟨🟨🟨🟨🟨🟨🟨🟨🟨🟨🟨🟨🟨🟨🟨🟨🟨🟨🪨🟨❎🟨🟨🪵🟨🪨🟨🌳🟨🟩🟨❎❎🟨🟨🌳🟨🌳🟨🪨🟩🪨🟨🟨🟨🟨🟨🟨❎🟨🌳🟨🟨🟨🟨🟨🪵🌳🟨🟨🟨🌳🪨🟨🟨🌳🟨🟨🟨🟨🟨❎🟨🟨🟩🟩🟩🟩🟨🪵🌳🪨🪨🟨🟨🌳🟩🟩🟩🪵🟩🟩🟩🟩🟩🟩🟩🟨🟨🟨🟨🟨
🟨🟨🟨🟨🟨🟨🟨🟨🟨🟨🟨🟨🟨🟨🟨🟨🌳🟨❎🟨🟨❎❎🟨❎🟨🟨❎🟩🟩🟩🟩🟩❎🟨🟨🪵🟨🟨🪵🟨🟨🟨🟩🌳🟨🟨🪨❎🟨❎🟨🟨🟨🟨🟩❎🟩🌳🟨🟨🟨🟨🟨🪨🟨🌳🟨🪵🪨❎🟨🟨🌳🟨❎🟨🟩🟩🟩🟩❎🪵❎🟨🟨🟨🟨🟩🟩🟩🟩🟩🟩🟩🟩🟩🟩🟩🟨🟨🟨🟨🟨🟨
🟨🟨🟨🟨🟨🟨🟨🟨🟨🟨🟨🟨🟨🟨🟨🟨🪨❎🟨🪨🟨❎❎🟨🟨❎❎🟩🟩🟩🟩🟩🟩❎🟨🪵🟨🟨🟨🟨🟨🌳🟩🟩🌳🟨🟨❎🟩🪵🪵🟩🟩🟩🟨🟩🟩🟩🟨🟨🟨🟨🪵❎🟨🟨🟨❎🟨🌳🌳🟨🪨🟨🪨🟨🟨🟩🟩🟩🟩🌳🟨🪵🟨🟨🟨🪵🪵🟩🟩🟩🟨🪨🟩🟩🟩🪨🟩🟩🟨🟨🟨🟨🟨
🟨🟨🟨🟨🟨🟨🟨🟨🟨🟨🟨🟨🟨🟨🟨🟨🟨✨🪵🟨🟨🟨❎🟨🟨🪨🟩🟩🟩🟩🟩🟩🟩🟩🟨🟨🪵🟨🟨❎🟩🟩🟩🟩🟩🟩🟩🟩🟩🟩🟩🟩🟩🟩🟩🪵🪵🟩🪵🟨🟨🟩🟩🟩❎🟨❎🪵❎🟨🟨🟨🟨🪵🟨🪨🟨🟩🟩🟩🟩🟩❎❎🪨🟨🟨🪵🪵🟨🟨🟨🟨🟨🟩🟨🟨🟨🟨🟨🟨🟨🟨🟨🟨
🟨🟨🟨🟨🟨🟨🟨🟨🟨🟨🟨🟨🟨🟨🟨🟨🪨❎🟨🟨🟨❎🟨❎🪨🟩🟩🟩🟩🟩🟩🟩🟩🟩🪨🟨❎🪨❎🪵❎🟩🟩🟩🟩🟩🟩🟩🟩🟩🟩🟩🟩🪨🟩🪵🪵🟩🟩🟨🟨🟩🟩🟩🟩🟩🟩🌳🟨🟨🟨🌳🟨🟨🪨🟨🟨🟨🟨🟨🟨🟨🟨🟨🟨🟨🟨🟨🟨🟨🟨🟨🟨🟨🟨🟨🟨🟨🟨🟨🟨🟨🟨🟨🟨
🟨🟨🟨🟨🟨🟨🟨🟨🟨🟨🟨🟨🟨🟨🟨🟨🟨🟨🟨🌳❎🟨🟨🌳🟨❎🟩🟩🟩🪵🪵🟩🟩🟩❎🪵🪵🪵🟨🪨❎🟩🌳🟩🟩🟩🟩🟩🟩🟩🪵🟩🟩🟩🟩🟩🟨🟨🟨🟩🪵🪵🟩🟩🟩🟩🪨🟨🌳🟨🟨🟨❎🟨🟨❎🟨🟨🟩🌳🟨🟨🟨🪨🟨🟨🟨🟨🟨🟨🟨🟨🟨🟨🟨🟨🌳🟨🟩🟩🟨🟨🟨🟨🟨
🟨🟨🟨🟨🟨🟨🟨🟨🟨🟨🟨🟨🟨🟨🟨🟨❎🟨❎🟨🟨❎🪨🟨❎🟩🟩🟩🟩🪵🪵🟩🟩🟩🟩🪵🪵❎❎❎🟩🟩🟩🟩🟩🟩🪵🪵🟩🟩🟩🟩🟩🪵🪵🟨🟨🟩🟩🟩🪵🪵🟩🟩🟩🟨🟨🟨🟨🟨🪨🪨🟨❎❎🟨🟨🟨🟨🟨🟨🟨❎🟨🟩🟨🪨🪨🟨🪵🟨🟨🟨🟨🪵🪵❎❎🟩🟩🟨🟨🟨🟨🟨
🟨🟨🟨🟨🟨🟨🟨🟨🟨🟨🟨🟨🟨🟨🟨🟨🪨🟨🟨🟨🪵🟨🪨❎❎🌳🟩🟩🟩🟩🟩🟩🟩🟩❎❎❎🪨🪵🪵❎❎🟩🟩🪵🟩🪵🪵🟩🟩🟩🟩🟩🪵🪵🟨🟨🟩🟩🪨🟩🟩🟩🟩🟩🌳🟨❎🟨🟨🪵❎🟨🟨🟨❎🟨🟨🟨🟨🟨🟩🟩🟩🟩🟨🪵❎❎🟨🌳🟨🟨🟨🟨🟨❎🟨🪨🟨🟨🟨🟨🟨🟨
🟨🟨🟨🪵🪵🟨🟨🟨🟨🟨🟨🟨🟨🟨🟨🟨🟨🟨🟨❎❎🟨❎🟨❎❎🟩🟩🟩🟩🟩🟩🟩🟩🟩🪵🪨🟨🪵🪵🪨❎🟩🟩🟩🟩🟩🟩🟩🟩🟩🟩🟩🟨🟨🟨🟨🪵🪵🟩🟩🟩🟩🟩🟩🟩❎🟨❎🟨🟨🟨🌳🪨🟨🟨🟨🟨🌳🪵🪵🪨🟩❎❎🟨❎🟨🪨🪨🟨🟨🟨🟨🪵🟨🟨🌳🟨🟨🟨🟨🟨🟨🟨
🟨🟨🟨🪵🪵🟨🟨🟨🟨🟨🟨🟨🟨🟨🟨🟨❎🟨🟨🟨🟨❎🟨🟨🟨❎🪨🟩🟩🟩🟩🟩🟩🟩❎🪨🪨🪨🪨❎🪵🟨🟨🟩🌳🟩🟩🟩🪨🟩🟩🟩🟨🟨🟨🟨🟩🪵🪵🟩🟩🟩🪵🟩🟩❎🟨❎🟨🟨❎❎❎🟨❎❎🟨🟨🟨🟨❎🟩🟩🟩🟩❎❎🟨🟨🟨🟨🟨🟨🪨❎🟩❎🟨🟨❎❎🟨🟨🟨🟨
🟨🟨🟨🟨🟨🟨🟨🟨🟨🟨🟨🟨🟨🟨🟨🟨❎🟨🪵🪨❎🟨🟨🟨🌳🟨🟨🟩🟩🟩🟩🟩🟨🟨🟨🪨🪨🪨🟨🟨❎❎❎🟩🟩🟩🟩🟩🟩🟩🪵🪵🟨🟨🟨🟩🟩🟩🟩🟩🟩🟩🟩🌳🟩🟨🪨🌳🟨🟨🟨🪨🟨🪵🟨🟨🟨❎❎🟨❎🟨🪵🪨❎🟨🟨❎🪨🟨🟨🟨🟨🟨❎🟩🪨🟩🟩🟩❎🟩🟩🟨🟨
🟨🟨🟨🟨🟨🟨🟨🟨🟨🟨🟨🟨🟨🟨🟨🟨🟨❎🟨🟨🟨🟨❎🪨🪨🟨❎🟩❎🪨🟩🪵🟨🟨❎🟨🟨🪨🪵🟨❎🟨🟨❎🟨❎🟩🟩🟩🪨🪵🪵🟨🟨🪵🟩🟩🟩🌳🟩🟩🟩🟩🟩🟩🟨❎🟨🟨❎🟨❎🪵🟨🟨❎🟨🟨🟨🟨🟨❎🟨🪵🟨🟨🌳🟨🪨🟨🟨🟨🟨🟨❎🟩🟩🟩🟩🟩🟩🟩🟩🟨🟨
🟨🟨🟨🟨🟨🟨🪵🪵🟨🟨🟨🟨🟨🟨🟨🟨🪵🌳🟨❎🟨❎🪵🪵🟨🟨🟨🟨❎🟨🪨🟨🟨🌳🟨🟨🪵🪵🟨🟨🟨🟨🌳🟨❎🟨🟨🌳🟨🟨🟨🟨🟨🟨🟨🟩🟩🟩🟩🟩🟩🟩🟩🟩🌳❎🌳❎🟨🪵❎🟨🟨❎🪨🪨🟨🟨🟨🟨🪵❎🟨❎🟨❎🟨🟨🟨🟩🟩🟨🌳🟨🟩🟩🟩🟩🟩🟨🟨🟨🟨🟨🟨
🟨🟨🟨🟨🟨🟨🪵🪵🟨🟨🟨🟨🟨🟨🟨🟨🟨❎🟨🟨🪨🟨🟨🌳🟨🟨🟨🟨🌳🟨🟨🟨🪨🟨🟨🟨🟨🟨❎🟨🪵🟨🌳🪵🟨🟨❎🟨🟨🟨🟨🌳🟨🟨🟩🟩🌳🟩🟩🟩🟩🟩🟩🟩🟨🌳🟨🟨❎🪨🟨❎❎❎🟨❎🟨🟨🟨🟩🟨❎🟨🪵🪨🟨🟨🪵🟩🟩🟨🟨🟨🟩🟩🟩🪨🟩🟨🟨🌳❎🟨🟨🟨
🟨🟨🟨🟨🟨🟨🟨🟨🟨🟨🟨🟨🟨🟨🟨🟨🟨🟨🌳🟨🟨🟨🌳🟨🟨🪨🟨❎🟨❎🪨🟨🌳🪨🟨🟨❎🪵🟨🟨🪨🪨❎🟨🪨🟨🟨🟨🪨🟨🟨🟨❎🟨🪨🟨❎🟩❎🟩🌳🌳🟩🟨❎🟨❎🟨🟨❎❎🌳🟨🪵🟨🟨🟨🟨🟩🟩🟨❎🟨🟨🟨🟨🟨🟩🟩❎🟨🟨🟨🟨🟩🟩🟩🟨🪵🪵🟨🪨🟨🟨🟨
🟨🟨🟨🟨🟨🟨🟨🟨🟨🟨🟨🟨🟨🟨🟨🟨🟨🟨🟨🟨❎🌳❎🌳❎🟨🟨🌳🟨🟨🪵🟨❎🟨🟨🌳❎🟨🪨🟨🟨🌳🟨🪵🟨🌳🪨🪨🪨🟨🪨🟨🟨🟨🪨❎🟨🟨🟨🟨❎🟨🟩🟩🟨❎🟨❎🪨🟨🟨🟨❎❎🪨🟨🟨🟩🟩🟩🟩❎🟨🟨🟩🪨🟩🟩🟩🟩🟩🟨🟨🌳🟩🟩🟩❎🟨🟨🟨❎🟨🟨🟨
🟨🟨🟨🟨🟨🟨🟨🟨🟨🟨🟨🟨🟨🟨🟨🟨❎🟩🪵🟨🟨🟨❎🟨🟨🟨🟨❎🟨🟨🌳🟨🟨❎❎❎🟨🪵🪨🪨❎🪨❎🟨🟨🟨🟨🪨🪨🟨🟨🪨🟨🪨🪨🟨🟨❎🪨🪨🟨🟨❎🪨🟨🟨❎🟨🟨🪨🪨🪨❎🟨❎🟨🟨🟨🟨🟩🟩🟩🟨🪵🟩🟩🟩🟩🟩🟩🟨🟨🟨🟨🟩🟩❎🌳❎🟨❎❎🟨🟨🟨
🟨🟨🟨🪵🪵🟨🟨🟨🟨🟨🟨🟨🟨🟨🟨🟩🟩🟩🟩🟨🌳🟨🟨❎🟨🌳🟨🟨🪵🟨🟨🟨🟨🟨🟨🟨🪨🟨🪨🪨🌳🟨🟨🟨🌳❎🟨🪨🟨🟨🪨🟨🪨🪨🪨❎🟨❎❎🪨🪨🪨🟨🟨🪨🟨❎🪨🟨🪨🪨🟨❎🪨🟨❎🟨🟨🟨🟨🟨🟨🟨🟨🌳🪵🪵🟩🟩🟩🟨🟨🟨🟨🪨🟨🪵🟨🪵🪵🟨❎🟨🟨🟨
🟨🟨🟨🪵🪵🟨🟨🟨🟨🟨🟨🟨🟨🟨🟨🟩🟩🌳🟨🪨🟨🪵🪨🟨🟨🪨🟨❎🟨❎🟨🪨🟨🌳🟨🪨🪨🪨🟨❎🟨❎🪵❎🟨🟨🟨🟨🟨🟨🟨🟨🟨🪨🟨🟨🪨🪨🟨🪨🪨❎🪨🪨🪨🪨🟨🟨🪨🟨🪵❎🟨🟨🟨🟨🟨🟨🟨🟨🟨❎🟨🌳🟨🪵🪵🪨🟩🟩🟨🟨🟨🟨🟩🟨❎❎🪵🪵❎🟨🟨🟨🟨
🟨🟨🟨🟨🟨🟨🟨🟨🟨🟨🟨🟨🟨🟨🟨🟨❎🟨🪨🟨🟨🟨🟨🪨🪨🪨🟨🟨🟨🟨🟨🟨🪨🟨🟨🟨🪨🪨❎🟨❎🪨🟨🟨🟨🪵🟨🟨🟨🪨❎🪨🟨🪵🟨🪨🪨❎🟨❎❎🪨❎🟨🪨🪨🟨🪨🟨❎🪨🟨🟨🟨🟨❎🟨🟨🟨🟨🟨🟨❎🟨❎❎❎🟨🟩🟩🟨🟨🟨🟨🟩🟩🟨🪵❎🪵🟩🟩🟩🟨🟨
🟨🟨🟨🟨🟨🟨🪵🪵🟨🟨🟨🟨🟨🟨🟨🟨🟨🟨🟨🟨🟨🟨❎🪨🪨🟨🪵🟨🟨🟨🟨❎❎🟨❎🪨🪨🟨🌳🪨🪨🟨🌳🟨🟨🟨🟨🟨🪨🟨🪨🟨🪨🟨🪨🪨🪨🟨❎❎🟨🪨🪵🪨🪵🟨🪨❎❎❎❎🟨❎🟨❎❎🟨🟨🟨🟨🟨🟨❎🟨🟨❎🟨🟩🪵🟩🟨🟨🟨🟨🟩🟩❎🪨🟨❎🪨🟩🟩🟨🟨
🟨🟨🟨🟨🟨🟨🪵🪵🟨🟨🟨🟨🟨🟨🟨🟨🟨🟨🟨❎🟨🟨🟨🪵❎🟨🟨❎🟨🪵🟨🟨🟨🪨🪨❎🪵❎🟨🟨🟨❎🟨🟨🟨🟨🟨🟨🪨🟨❎🟨🪨🪨🪨🟨🪨🟨🪨🪨🪨🟨❎🟨🟨🪨🪨🌳🟨❎🟨🪨🟨🪵❎🪨🟦🟦🟦🟦🟦🟦🟦🟨❎🟨🟩🟩🟨🌳🟨🟨🟨🟨🟩🟩🌳🟨🟩🟩🟩🟩🟩🟨🟨
🟨🟨🟨🟨🟨🟨🟨🟨🟨🟨🟨🟨🟨🟨🟨🟨🟨🟨🌳🟨🟨🟨🟨🌳🪨🟨🟨🟨❎🟨🟨❎🟨🪨🪨❎🪵🟨🟨🌳🟨❎🟨🪵🪨🟨🪨🪨🟨🪨🟨❎❎🪨🪨🟨🪨❎🟨🟨🟨🟨🪨🪨🪨🟨❎🟨❎❎🟨❎❎🟨🟨❎🟦🟦🟦🟦🟦🟦🟦🟨🟨🟨🟩🟩🟩🟩🟨🟨🟨🪨🟩🟩🟩🟨🌳🟩🪨🟩🟩🟨🟨
🟨🟨🟨🟨🟨🟨🟨🟨🟨🟨🟨🟨🟨🟨🟨🟨🟨🟨🟨🪨🪨🟨❎🟨🪵❎🟨🟨🟨❎🌳🟨🟨🟨🟨🟨🟨🪵🟨🟨🟨🟨🟨🟨🪨🟨🪨🪨🪨🟨🪨❎🟨🟨🪨🟨🪨🪨🟨🪨🟨❎🪨🟨❎❎🟨❎🟨🪵❎🟨❎🟨🪨🪨🟦🟦🟦🟦🟦🟦🟦🟦🟦🟦🟦🟩🟨🟨🟨🟨🟨🟨🟩🟩🟩🟩❎🟨🪵🟨🟩🟨🟨
🟨🟨🟨🟨🟨🟨🟨🟨🟨🟨🟨🟨🟨🟨🟨🟨🟨🟨🪵🟨🟨🟨🟨🟨❎🟨🟨❎🟨🟨🟨🟨🟨❎🟨🪵🟨🟨🟨🟨🟨🟨🪵🟨🟨🟨🟨🪨🟨🪨🟨🪵🪨❎🟨🟨🪨🪨🟨🟨❎🟨🟨❎🪵🟨🟨🟨❎🪨🟨❎🪨❎🟨❎🟨🟦🟦🟦🟦🟦🟦🟦🟦🟦🟦🟦🟨🟨🟨🟨🟨🟨🪵🟩🟩❎❎🟨🟨🟨🟨🟨🟨
🟨🟨🟨🟨🟨🟨🟨🟨🟨🟨🟨🟨🟨🟨🟨🟨🟨🟨🟨🟨❎🟨🌳🟨🟨🟨🪨🟨🟨🪵❎🟨❎🟨🟨🟨🟨❎🟨🟨🪨🟨🟨🟨🟨🪵🟨🟨❎🟨🪨🟨🟨🟨❎❎🟨🟨🪵❎🟨🟨🟨❎❎🟨❎❎🟨❎❎🌳🟨🪵🌳🟨🟨🟦🟦🟦🟦🟦🟦🟦🟦🟦🟦🟦🟦🟦🟦🟦🟨🟨🟨🟨🟨🟨🟨🟨🟨🟨🟨🟨🟨
🟨🟨🟨🟨🟨🟨🟨🟨🟨🟨🟨🟨🟨🟨🟨🟨🟨🟨🟨🟨🪨🟨🟨🟨🟨🟨🟨🟨🟨❎🟨❎🟨❎❎🪵🟨🟨🟨🟨🟨🟨🟨🟨🟨🟨🟨🟨🟨❎🟨🟨🟨🟨🟨🟨❎🟨🟨🟨🟨🌳🟨🟨🟨🟨🟨❎🪨🟨🟨🟨❎❎🪨🟨🟦🟦🟦🟦🟦🟦🟦🟦🟦🟦🟦🟦🟦🟦🟦🟦🟨🟨🟨🟨🟨🟨🟦🟦🟦🟦🟦🟨🟨
🟨🟨🟨🟨🟨🟨🟨🟨🟨🟨🟨🟨🟨🟨🟨🟨🟨🟨🟨🟨🟨❎❎🟨🟨🪵🪵🪵🟨🟨🟨🟨🟨🟨🟨🟨🟨🟨🟨🟨🟨🟨🟨🟨🟨🟨🟨🟨🟨🟨🟨🟨🟨🟨🟨🟨🟨🟨🟨🟨🟨🟨🟨🟨🟨🟨🟨❎🟨🟨🟨🟦🟦🟦🟦🟦🟦🟦🟦🟦🟦🟦🟦🟦🟦🟦🟦🟦🟦🟦🟦🟦🟦🟦🟦🟦🟦🟦🟦🟦🟦🟦🟦🟦🟦
🟨🟨🟨🟨🟨🟨🟨🟨🟨🟨🟨🟨🟨🟨🟨🟨🟨🟨🟨🟨🟨🟨🟨🟨🟨❎🪵🟨🪵🟨🟨🟨🟨🟨🟨🟨🟨🟨🟨🟨🟨🟨🟨🟨🟨🟨🟨🟨🟨🟨🟨🟨🟨🟨🟨🟨🟨🟨🟨🟨🟨🟨🟨🟨🟨🟨🟨🟨🟨🟨🟨🟦🟦🟦🟦🟦🟦🟦🟦🟦🟦🟦🟦🟦🟦🟦🟦🟦🟦🟦🟦🟦🟦🟨🟨🟨🟦🟦🟦🟦🟦🟦🟦🟦🟦
🟨🟨🟨🟨🟨🟨🟨🟨🟨🟨🟨🟨🟨🟨🟨🟨🟨🟨🟨🟨🟨🟨🟨🟨🟨🟨🟨🟨🟨🟨🟨🟨🟨🟨🟨🟨🟨🟨🟨🟨🟨🟨🟨🟨🟨🟨🟨🟨🟨🟨🟨🟨🟨🟨🟨🟨🟨🟨🟨🟨🟨🟨🟨🟨🟨🟨🟨🟨🟨🟨🟨🟦🟦🟦🟦🟦🟦🟦🟦🟦🟦🟦🟦🟦🟦🟦🟦🟦🟦🟦🟦🟦🟦🟨🟨🟨🟦🟦🟦🟦🟦🟦🟦🟦🟦
🟨🟨🟨🟨🟨🟨🟨🟨🟨🟨🟨🟨🟨🟨🟨🟨🟨🟨🟨🟨🟨🟨🟨🟨🟨🟨🟨🟨🟨🟨🟨🟨🟨🟨🟨🟨🟨🟨🟨🟨🟨🟨🟨🟨🟨🟨🟨🟨🟨🟨🟨🟨🟨🟨🟨🟨🟨🟨🟨🟨🟨🟨🟨🟨🟨🟨🟨🟨🟨🟨🟨🟦🟦🟦🟦🟦🟦🟦🟦🟦🟦🟨🟨🟦🟦🟦🟦🟦🟦🟦🟦🟦🟦🟦🟦🟦🟦🟦🟦🟦🟦🟦🟦🟦🟦
🟨🟨🟨🟨🟨🟨🟨🟨🟨🟨🟨🟨🟨🟨🟨🟨🟨🟨🟨🟨🟨🟨🟨🟨🟨🟨🟨🟨🟨🟨🟨🟨🟨🟨🟨🟨🟨🟨🟨🟨🟨🟨🟨🟨🟨🟨🟨🟨🟨🟨🟨🟨🟨🟨🟨🟨🟨🟨🟨🟨🟨🟨🟨🟨🟨🟨🟨🟨🟨🟨🟨🟦🟦🟦🟦🟦🟦🟦🟦🟦🟦🟨🟨🟦🟦🟦🟦🟦🟦🟦🟦🟦🟦🟦🟦🟦🟦🟦🟦🟦🟦🟦🟦🟦🟦
🟨🟨🟨🟨🟨🟨🟨🟨🟨🟨🟨🟨🟨🟨🟨🟨🟨🟨🟨🟨🟨🟨🟨🟨🟨🟨🟨🟨🟨🟨🟨🟨🟨🟨🟨🟨🟨🟨🟨🟨🟨🟨🟨🟨🟨🟨🟨🟨🟨🟨🟨🟨🟨🟨🟨🟨🟨🟨🟨🟨🟨🟨🟨🟨🟨🟨🟨🟨🟨🟨🟨🟨🟨🟦🟦🟦🟦🟦🟦🟦🟦🟦🟦🟦🟦🟦🟦🟦🟦🟦🟦🟦🟦🟦🟦🟦🟦🟦🟦🟦🟦🟦🟦🟦🟦
🟨🟨🟨🟨🟨🟨🟨🟨🟨🟨🟨🟨🟨🟨🟨🟨🟨🟨🟨🟨🟨🟨🟨🟨🟨🟨🟨🟨🟨🟨🟨🟨🟨🟨🟨🟨🟨🟨🟨🟨🟨🟨🟨🟨🟨🟨🟨🟨🟨🟨🟨🟨🟨🟨🟨🟨🟨🟨🟨🟨🟨🟨🟨🟨🟨🟨🟨🟨🟨🟨🟨🟨🟨🟦🟦🟦🟦🟦🟦🟦🟦🟦🟦🟦🟦🟦🟦🟦🟦🟦🟦🟦🟦🟦🟦🟦🟦🟦🟦🟦🟦🟦🟦🟦🟦
🟨🟨🟨🟨🟨🟨🟨🟨🟨🟨🟨🟨🟨🟨🟨🟨🟨🟨🟨🟨🟨🟨🟨🟨🟨🟨🟨🟨🟨🟨🟨🟨🟨🟨🟨🟨🟨🟨🟨🟨🟨🟨🟨🟨🟨🟨🟨🟨🟨🟨🟨🪨🟨🟨🪨🪨🟨🟨🪨🟨🟨🟨🟨🟨🟨🟨🟨🟨🟨🟨🟨🟨🟨🟦🟦🟦🟦🟦🟦🟦🟦🟦🟦🟦🟦🟦🟦🟦🟦🟦🟦🟦🟦🟦🟦🟦🟦🟦🟦🟦🟦🟦🟦🟦🟦
🟨🟨🟨🟨🟨🟨🟨🟨🟨🟨🟨🟨🟨🟨🟨🟨🟨🟨🟨🟨🟨🟨🟨🟨🟨🟨🟨🟨🟨🟨🟨🟨🟨🟨🟨🟨🟨🟨🟨🟨🟨🟨🟨🟨🟨🟨🟨🪨🪨🟨🟨🟨🟨🪨🟨🪨🪨🟨🟨🪨🪨🪨🟨🟨🟨🟨🟨🟨🟨🟨🟨🟨🟨🟨🟦🟦🟦🟦🟦🟦🟦🟦🟦🟦🟦🟦🟦🟦🟦🟦🟦🟦🟦🟦🟦🟦🟦🟦🟦🟦🟦🟨🟨🟦🟨
🟨🟨🟨🟨🟨🟨🟨🟨🟨🟨🟨🟨🟨🟨🟨🟨🟨🟨🟨🟨🟨🟨🟨🟨🟨🟨🟨🪵🪵🟨🟨🟨🟨🟨🟨🟨🟨🟨🟨🟨🟨🟨🟨🟨🟨🟨🪨🪨🪨🟨🪨🪨🪨🟨🟨🟨🪨🟨🟨🪨🪨🟨🟨🟨🟨🟨🟨🟨🟨🟨🟨🟨🟨🟨🟦🟦🟦🟦🟦🟦🟦🟦🟦🟦🟦🟦🟦🟦🟦🟦🟦🟦🟦🟦🟦🟦🟦🟦🟦🟦🟨🟨🟨🟦🟦
🟨🟨🟨🪵🪵🟨🟨🟨🟨🟨🟨🟨🟨🟨🟨🟨🟨🟨🟨🟨🟨🟨🟨🟨🟨🟨🟨🪵🪵🟨🟨🟨🟨🟨🟨🟨🟨🟨🟨🟨🟨🟨🟨🟨🟨🟨🟨🟨🟨🪨🟨🪨🪨🪨🟨🟨🟨🪨🪨🪨🪨🟨🪨🟨🟨🟨🟨🟨🟨🟨🟨🟨🟨🟨🟨🟨🟨🟦🟦🟦🟦🟦🟦🟦🟦🟦🟦🟦🟦🟦🟦🟦🟦🟦🟦🟦🟦🟦🟦🟦🟦🟨🟨🟨🟨
🟨🟨🟨🪵🪵🟨🟨🟨🟨🟨🟨🟨🟨🟨🟨🟨🟨🟨🟨🟨🟨🟨🟨🟨🟨🟨🟨🟨🟨🟨🟨🟨🟨🟨🟨🟨🟨🟨🟨🟨🟨🟨🟨🟨🟨🟨🟨🪨🟨🟨🪨🟨🪨🪨🪨🟨🪨🟨🪨🟨🪨🟨🟨🟨🟨🟨🟨🟨🟨🟨🟨🟨🟨🟨🟨🟨🟨🟨🟦🟦🟦🟦🟦🟦🟦🟦🟦🟦🟦🟦🟦🟦🟦🟦🟦🟦🟦🟦🟦🟦🟦🟦🟦🟦🟦
🟨🟨🟨🟨🟨🟨🟨🟨🟨🟨🟨🟨🟨🟨🟨🪵🪵🟨🟨🟨🟨🟨🟨🟨🟨🟨🟨🟨🟨🟨🟨🟨🟨🟨🟨🟨🟨🟨🟨🟨🟨🟨🟨🟨🟨🟨🟨🟨🪨🪨🟨🟨🪨🟨🪨🟨🟨🪨🟨🪨🪨🟨🟨🟨🪨🪨🪨🪨🟨🟨🟨🟨🟨🟨🟨🟨🟨🟨🟦🟦🟦🟦🟦🟦🟦🟦🟦🟦🟦🟦🟦🟦🟦🟦🟦🟦🟦🟦🟦🟦🟦🟦🟦🟦🟦
🟨🟨🟨🟨🟨🟨🟨🟨🟨🟨🟨🟨🟨🟨🟨🪵🪵🟨🟨🟨🟨🟨🟨🟨🟨🟨🟨🟨🟨🟨🟨🟨🟨🟨🟨🟨🟨🟨🟨🟨🟨🟨🟨🟨🟨🟨🟨🟨🪨🪨🟨🪨🟨🟨🪨🪨🟨🟨🟨🪨🪨🟨🪨🟨🟨🪨🪨🪨🟨🟨🟨🟨🟨🟨🟨🟨🟨🟨🟦🟦🟦🟦🟦🟦🟦🟦🟦🟦🟦🟦🟦🟦🟦🟦🟦🟦🟦🟦🟦🟦🟦🟦🟦🟦🟦
🟨🟨🟨🟨🟨🟨🟨🟨🟨🟨🟨🟨🟨🟨🟨🟨🟨🟨🟨🟨🟨🟨🟨🟨🟨🟨🟨🟨🟨🟨🟨🟨🟨🟨🟨🟨🟨🟨🟨🟨🟨🟨🟨🟨🟨🟨🟨🪨🪨🪨🪨🟨🪨🟨🪨🪨🪨🟨🟨🪨🟨🟨🟨🪨🪨🟨🟨🪨🟨🟨🟨🟨🟨🟨🟨🟨🟨🟨🟦🟦🟦🟦🟦🟦🟦🟦🟦🟦🟦🟦🟦🟦🟦🟦🟦🟦🟦🟦🟦🟦🟦🟦🟦🟦🟦
🟨🟨🟨🟨🟨🟨🟨🟨🟨🟨🟨🟨🟨🟨🟨🟨🟨🟨🟨🟨🟨🟨🟨🟨🟨🟨🟨🟨🟨🟨🟨🟨🟨🟨🟨🟨🟨🟨🟨🟨🟨🟨🟨🟨🟨🟨🟨🟨🪨🟨🟨🪨🟨🪨🪨🟨🪨🟨🟨🟨🟨🟨🟨🟨🟨🟨🟨🟨🟨🟨🟨🟨🟨🟨🟨🟨🟨🟨🟦🟦🟦🟦🟦🟦🟦🟨🟨🟦🟦🟦🟦🟦🟦🟦🟦🟦🟦🟦🟦🟦🟦🟦🟦🟦🟦
🟨🟨🟨🟨🟨🟨🟨🟨🟨🟨🪵🪵🟨🟨🟨🟨🟨🟨🟨🟨🟨🟨🟨🟨🟨🟨🟨🟨🟨🟨🟨🟨🟨🟨🟨🟨🟨🟨🟨🟨🟨🟨🟨🟨🟨🟨🟨🟨🟨🟨🟨🟨🟨🟨🟨🟨🪨🪨🪨🟨🟨🟨🟨🪨🪨🪨🪨🪨🟨🟨🟨🟨🟨🟨🟨🟨🟨🟨🟦🟦🟦🟦🟦🟦🟦🟨🟨🟨🟦🟨🟦🟦🟦🟦🟦🟦🟦🟦🟦🟦🟦🟦🟦🟦🟦
🟨🟨🟨🟨🟨🟨🟨🟨🟨🟨🪵🪵🟨🟨🟨🟨🟨🟨🟨🟨🟨🟨🟨🟨🟨🟨🪵🪵🟨🟨🟨🟨🟨🟨🟨🟨🟨🟨🟨🟨🟨🟨🟨🟨🟨🟨🟨🟨🟨🟨🟨🟨🟨🟨🪨🪨🟨🪨🪨🪨🟨🪨🪨🪨🟨🪨🪨🟨🟨🟨🟨🟨🟨🟨🟨🟨🟨🟨🟨🟦🟦🟦🟦🟦🟦🟦🟦🟦🟦🟦🟦🟦🟦🟦🟦🟦🟦🟦🟦🟦🟦🟦🟦🟦🟦
🟨🟨🟨🟨🟨🟨🟨🟨🟨🟨🟨🟨🟨🟨🟨🟨🟨🪵🪵🟨🟨🟨🟨🟨🟨🟨🪵🪵🟨🟨🟨🟨🟨🟨🟨🟨🟨🟨🟨🟨🟨🟨🟨🟨🟨🟨🟨🟨🟨🟨🟨🟨🟨🟨🟨🪨🪨🟨🟨🪨🟨🪨🪨🟨🪨🪨🟨🪨🟨🟨🟨🟨🟨🟨🟨🟨🟨🟨🟨🟦🟦🟦🟦🟦🟦🟦🟦🟦🟦🟦🟦🟦🟦🟦🟨🟨🟦🟦🟦🟦🟦🟦🟦🟦🟦
🟨🟨🟨🟨🟨🟨🟨🟨🟨🟨🟨🟨🟨🟨🟨🟨🟨🪵🪵🟨🟨🟨🟨🟨🟨🟨🟨🟨🟨🟨🟨🟨🟨🟨🟨🟨🟨🟨🟨🟨🟨🟨🟨🟨🟨🟨🟨🟨🟨🟨🟨🟨🟨🟨🟨🟨🪨🟨🟨🟨🟨🟨🪨🟨🟨🟨🟨🟨🟨🟨🟨🟨🟨🟨🟨🟨🟨🟨🟨🟦🟦🟦🟦🟦🟦🟦🟦🟦🟦🟦🟦🟦🟦🟦🟨🟨🟦🟦🟦🟦🟦🟦🟦🟦🟦
🟨🟨🟨🟨🟨🟨🟨🟨🟨🟨🪵🪵🟨🟨🟨🟨🟨🟨🟨🟨🟨🟨🟨🟨🟨🟨🟨🟨🟨🟨🟨🟨🟨🟨🟨🟨🟨🟨🟨🟨🟨🟨🟨🟨🟨🟨🟨🟨🟨🟨🟨🟨🟨🟨🟨🟨🟨🟨🟨🟨🟨🟨🟨🟨🟨🟨🟨🟨🟨🟨🟨🟨🟨🟨🟨🟨🟨🟨🟨🟦🟦🟦🟦🟦🟦🟦🟦🟦🟦🟦🟦🟦🟦🟦🟦🟦🟦🟦🟦🟦🟦🟦🟦🟦🟦
🟨🟨🟨🟨🟨🟨🟨🟨🟨🟨🪵🪵🟨🟨🟨🟨🟨🟨🟨🟨🟨🟨🟨🟨🟨🟨🟨🟨🟨🟨🟨🟨🟨🟨🟨🟨🟨🟨🟨🟨🟨🟨🟨🟨🟨🟨🟨🟨🟨🟨🟨🟨🟨🟨🟨🟨🟨🟨🟨🟨🟨🟨🟨🟨🟨🟨🟨🟨🟨🟨🟨🟨🟨🟨🟨🟨🟨🟨🟨🟦🟦🟦🟦🟦🟦🟦🟦🟦🟦🟦🟦🟦🟦🟦🟦🟦🟦🟦🟦🟦🟦🟦🟦🟦🟦
🟨🟨🟨🟨🟨🟨🟨🟨🟨🟨🟨🟨🟨🟨🟨🟨🟨🟨🟨🟨🟨🟨🟨🟨🟨🟨🟨🟨🟨🟨🟨🟨🟨🟨🟨🟨🟨🟨🟨🟨🟨🟨🟨🟨🟨🟨🟨🟨🟨🟨🟨🟨🟨🟨🟨🟨🟨🟨🟨🟨🟨🟨🟨🟨🟨🟨🟨🟨🟨🟨🟨🟨🟨🟨🟨🟨🟨🟨🟨🟦🟦🟦🟦🟦🟦🟦🟦🟦🟦🟦🟦🟦🟦🟦🟦🟦🟦🟦🟦🟦🟦🟦🟦🟦🟦