🟦🟦🟦🟦🟦🟦🟦🟦🟦🟦🟦🟦🟦🟦🟦🟦🟦🟦🟦🟦🟦🟦🟦🟦🟨🟨🟨🟨🟨🟨🟨🟨🟨🟨🟨🟨🟨🟨🟨🟨🟨🟨🟨🟨🟨🟨🟨🟨🟨🟨🟨🟨🟨🟨🟨🟨🟨🟨🟨🟨🟨🟨🟨🟨🟨🟨🟨🟨🟨🟨🟨🟨🟨🟨🟨🟨🟨🟨🟨🟨🟨🟨🟨🟨🟨🟨🟨🟨🟨🟨🟨🟨🟨🟨🟨🟨🟨🟨🟨🟨🟨🟨🟨🟨🟨
🟦🟦🟦🟦🟦🟦🟦🟦🟦🟦🟦🟦🟦🟦🟦🟦🟦🟦🟦🟦🟦🟦🟦🟦🟨🟨🟨🟨🟨🟨🟨🟨🟨🟨🟨🟨🟨🟨🟨🟨🟨🟨🟨🟨🟨🟨🟨🟨🟨🟨🟨🟨🟨🟨🟨🟨🟨🟨🟨🟨🟨🟨🟨🟨🟨🟨🟨🟨🟨🟨🟨🟨🟨🟨🟨🟨🟨🟨🟨🟨🟨🟨🟨🟨🟨🟨🟨🟨🟨🟨🟨🟨🟨🟨🟨🟨🟨🟨🟨🟨🟨🟨🟨🟨🟨
🟦🟦🟦🟦🟦🟦🟨🟨🟨🟦🟦🟦🟦🟦🟦🟦🟦🟦🟦🟦🟦🟦🟦🟦🟨🟨🟨🟨🟨🟨🟨🟨🟨🟨🟨🟨🟨🟨🟨🟨🟨🟨🟨🟨🟨🟨🟨🟨🟨🟨🟨🟨🟨🟨🟨🟨🟨🟨🟨🟨🟨🟨🟨🟨🟨🟨🟨🟨🟨🟨🟨🟨🟨🟨🟨🟨🟨🟨🟨🟨🟨🟨🟨🟨🟨🟨🟨🟨🟨🟨🟨🟨🟨🟨🟨🟨🟨🟨🟨🟨🟨🟨🟨🟨🟨
🟦🟦🟦🟦🟦🟦🟦🟦🟦🟦🟦🟦🟦🟦🟦🟦🟦🟦🟦🟦🟦🟦🟦🟦🟨🟨🟨🟨🟨🟨🟨🟨🟨🟨🟨🟨🟨🟨🟨🟨🟨🟨🟨🟨🟨🟨🟨🟨🟨🟨🟨🟨🟨🟨🟨🟨🟨🟨🟨🟨🟨🟨🟨🟨🟨🟨🟨🟨🟨🟨🟨🟨🟨🟨🟨🟨🟨🟨🟨🟨🟨🟨🟨🟨🟨🟨🟨🟨🟨🟨🟨🟨🟨🟨🟨🟨🟨🟨🟨🟨🟨🟨🟨🟨🟨
🟦🟦🟦🟦🟨🟨🟨🟨🟨🟨🟦🟦🟦🟦🟦🟦🟦🟦🟦🟦🟦🟦🟦🟦🟨🟨🟨🟨🟨🟨🟨🟨🟨🟨🟨🟨🟨🟨🟨🟨🟨🟨🟨🟨🟨🟨🟨🟨🟨🟨🟨🟨🟨🟨🟨🟨🟨🟨🟨🟨🟨🟨🟨🟨🟨🟨🟨🟨🟨🟨🟨🟨🟨🟨🟨🟨🟨🟨🟨🟨🟨🟨🟨🟨🟨🟨🟨🟨🟨🟨🟨🟨🟨🟨🟨🟨🟨🟨🟨🟨🟨🟨🟨🟨🟨
🟦🟦🟦🟦🟨🟨🟨🟨🟨🟨🟨🟦🟦🟦🟨🟨🟨🟨🟦🟦🟦🟦🟦🟦🟨🟨🟨🟨🟨🟨🟨🟨🟨🟨🟨🟨🟨🟨🟨🟨🟨🟨🟨🟨🟨🟨🟨🟨🟨🟨🟨🟨🟨🟨🟨🟨🟨🟨🟨🟨🟨🟨🟨🟨🟨🟨🟨🟨🟨🟨🟨🟨🟨🟨🟨🟨🟨🟨🟨🟨🟨🟨🟨🟨🟨🟨🟨🟨🟨🟨🟨🟨🟨🟨🟨🟨🟨🟨🟨🟨🟨🟨🟨🟨🟨
🟨🟦🟦🟦🟨🟨🟨🟨🟨🟨🟨🟦🟦🟦🟨🟨🟨🟨🟦🟦🟦🟨🟨🟨🟨🟨🟨🟨🟨🟨🟨🟨🟨🟨🟨🟨🟨🟨🟨🟨🟨🟨🟨🟨🟨🟨🟨🟨🟨🟨🟨🟨🟨🟨🟨🟨🟨🟨🟨🟨🟨🟨🟨🟨🟨🟨🟨🟨🟨🟨🟨🟨🟨🟨🟨🟨🟨🟨🟨🟨🟨🟨🟨🟨🟨🟨🟨🟨🟨🟨🟨🟨🟨🟨🟨🟨🟨🟨🟨🟨🟨🟨🟨🟨🟨
🟨🟦🟦🟦🟨🟨🟨🟨🟨🟨🟨🟦🟦🟦🟨🟨🟨🟦🟦🟦🪵🟨🟨🟨🟨🟨🟨🟨🟨🟨🟨🟨🟨🟨🟨🟨🟨🪨🪵🟨🟨🪵🪨🟨❎❎🟨❎🟨🟨🟨🟨🟨🟨🟨🟨🟨🟨🟨🟨🟨🟨🟨🟨🟨🟨🟨🟨🟨🟨🟨🟨🟨🟨🟨🟨🟨🟨🟨🟨🟨🟨🟨🟨🟨🟨🟨🟨🟨🟨🟨🟨🟨🟨🟨🟨🟨🟨🟨🟨🟨🟨🟨🟨🟨
🟨🟦🟦🟦🟨🟨🟨🟨🟨🟨🟨🟦🟦🟦🟦🟦🟦🟦🟦🟦🟨🌳🟨🟨🟨🟨🟨🟨🟨🟨🟨🟨🟨🪨🟨🟨🟨🪨🟨🟨🟨🪨🟨🟨🟨🟨🟨🟨🟨🪨🟨🟨🟨🟨🟨🟨🟨🟨🟨🟨🟨🟨🟨🟨🟨🟨🟨🟨🟨🟨🟨🟨🟨🟨🟨🟨🟨🟨🟨🟨🟨🟨🟨🟨🟨🟨🟨🟨🟨🟨🟨🟨🟨🟨🟨🟨🟨🟨🟨🟨🟨🟨🟨🟨🟨
🟦🟦🟦🟦🟨🟨🟨🟨🟨🟨🟨🟦🟦🟦🟦🟦🟦🟦🟦🟦🟨🟨🟨🟨🟨🟨🟨🟨🟨🟨🟨🟨🟨🟨🟨🌳🟨🟨🟩🟨🟨🟨🪨🟨🌳🟨🪨🟨🪵🟨🟨🟨🟨🟨🟨🟨🟨🟨🟨🟨🟨🟨🟨🟨🟨🟨🟨🟨🟨🟨🟨🟨🟨🟨🟨🟨🟨🟨🟨🟨🟨🟨🟨🟨🟨🟨🟨🟨🟨🟨🟨🟨🟨🟨🟨🟨🟨🟨🟨🟨🟨🟨🟨🟨🟨
🟦🟦🟦🟦🟦🟨🟨🟨🟨🟨🟨🟦🟦🟦🟦🟦🟦🟦🟦🟨🟨🟨🟨🟨🟨🟨🟨🟨🟨🟨🟨🟨🟨🟨🟨🟨🟨🟨🟨🟨🟨🟨🟨🟨🟨🟨🟨🌳🟨🟨🟨🟨🟨🟨🟨🟨🟨🟨🟨🟨🟨🟨🟨🟨🟨🟨🟨🟨🟨🟨🟨🟨🟨🟨🟨🟨🟨🟨🟨🟨🟨🟨🟨🟨🟨🟨🟨🟨🟨🟨🟨🟨🟨🟨🟨🟨🟨🟨🟨🟨🟨🟨🟨🟨🟨
🟦🟦🟦🟦🟦🟦🟦🟦🟦🟦🟦🟦🟦🟦🟦🟦🟦🟦🟦🪨🟨🟨🟨🟨🟨🟨🟨🟨🟨🟨🟨🟨🟨🟨🟨🪵🟨🟨🟨🪵🪵🟨🟨🟨🟨❎🟨🪵🟨🟨🟨🟨🟨🪨🟨🟨🟨🟨🟨🟨🟨🟨🟨🟨🟨🟨🟨🟨🟨🟨🟨🟨🟨🟨🟨🟨🟨🟨🟨🟨🟨🟨🟨🟨🟨🟨🟨🟨🟨🟨🟨🟨🟨🟨🟨🟨🟨🟨🟨🟨🟨🟨🟨🟨🟨
🟦🟦🟦🟦🟦🟦🟦🟦🟦🟦🟦🟦🟦🟦🟦🟦🟦🟦🟦🟨🟨🪨🟨🟨🟨🟨🟨🟨🟨🟨🟨🟨🟨🟨🟨❎🟨❎🟨🪵🪵🪵🟨🟨🪨🟨❎🟩🟨🟨🟨🌳🟨🟨🟨🟨🟨🟨🟨🟨🟨🟨🟨🟨🟨🟨🟨🟨🟨🟨🟨🟨🟨🟨🟨🟨🟨🟨🟨🟨🟨🟨🟨🟨🟨🟨🟨🟨🟨🟨🟨🟨🟨🟨🟨🟨🟨🟨🟨🟨🟨🟨🟨🟨🟨
🟦🟦🟦🟦🟦🟦🟦🟦🟦🟦🟦🟦🟦🟦🟦🟦🟦🟦🟦🟦🟨🪨🟨🟨🟨🟨🟨🟨🟨🟨🟨🟨🟨🟨🟨🟨🟨🟨❎🟨❎🟨🟨🟨❎🟩🟩🟩🟩🟩🪵🟨❎🟨🟨🟨🌳🟨🟨🟨🟨🟨🟨🟨🟨🟨🟨🟨🟨🟨🟨🟨🟨🟨🟨🟨🟨🟨🟨🟨🟨🟨🟨🟨🟨🟨🟨🟨🟨🟨🟨🟨🟨🟨🟨🟨🟨🟨🟨🟨🟨🟨🟨🟨🟨
🟦🟦🟦🟦🟦🟦🟦🟦🟦🟦🟦🟦🟦🟦🟨🟨🟦🟦🟦🟦🟨🟨🟨🟨🟨🟨🟨🟨🟨🟨🟨🟨🟨🟨🟨❎🪵🟨🟨❎🟨❎🌳❎🟨🟩🟩🟩🟩🟩🟨🪵🟨🟨🟨🟨🟨🟨🟨🟨🟨🟨🟨🟨🟨🟨🟨🟨🟨🟨🟨🟨🟨🟨🟨🟨🟨🟨🟨🟨🟨🟨🟨🟨🟨🟨🟨🟨🟨🟨🟨🟨🟨🟨🟨🟨🟨🟨🟨🟨🟨🟨🟨🟨🟨
🟦🟦🟦🟦🟦🟦🟦🟦🟦🟨🟨🟨🟨🟨🟨🟨🟦🟦🟦🟦🟨🟨🟨🟨🟨🟨🟨🟨🟨🟨🟨🟨🟨🟨❎❎🟨🪨🟨🟨❎🟨🟨🟨🟨🟩🟩🟩🟩🟨🟨🟨🟨🟨🟨🟨🟨🟨🟨🟨🟨🟨🚫🟨🟨🟨🟨🟨🟨🟨🟨🟨🟨🟨🟨🟨🟨🟨🟨🟨🟨🟨🟨🟨🟨🟨🟨🟨🟨🟨🟨🟨🟨🟨🟨🟨🟨🟨🟨🟨🟨🟨🟨🟨🟨
🟦🟦🟦🟦🟦🟦🟦🟦🟦🟨🟨🟨🟨🟨🟨🟨🟦🟦🟦🟦🟨🟨🟨🪵🟨🟨🟨🟨🟨🟨🟨🟨🟨🟨🪨🌳❎🟨❎❎🟨❎🪵🟨🌳🟩🟩🟩🟩🟨🪨🟨🟨🟨🪨🟨🟨🟨🟨🌳🟨🚫🟨🟨🟨🟨🟨🟨🟨🟨🟨🟨🟨🟨🟨🟨🟨🤖🚫🟨🟨🟨🟨🟨🟨🟨🟨🟨🟨🟨🟨🟨🟨🟨🟨🟨🟨🟨🟨🟨🟨🟨🟨🟨🟨
🟦🟨🟨🟨🟨🟦🟦🟦🟦🟦🟨🟨🟨🟨🟨🟦🟦🟦🟦🟦🟨🟨🟨🟨🟨🟨🟨🟨🟨🟨❎🟨🪨🟨🌳🟨❎🟨🟨❎🌳🟨🟨🟨🟨🟩🟩🟩🟩🟩🟨🟨🟨🟨🟨🟨🟨🟨🟨🟨🟨🌱🟨🟨🟨🟨🟨🟨🟨🟨🟨🟨🟨🟨🟨🟨🟨🟨🚫🟨🟨🟨🟨🟨🟨🟨🟨🟨🟨🟨🟨🟨🟨🟨🟨🟨🟨🟨🟨🟨🟨🟨🟨🟨🟨
🟦🟨🟨🟨🟨🟦🟦🟦🟦🟦🟦🟦🟦🟦🟦🟦🟦🟦🟦🟦🟨🟨🟨🌳🟨🪵🟨🟨🪨🟨🟨🪵❎🟨🟨🪨🪵🪵🟨🪨❎🟨❎🟨❎🟩🟩🟩🟩🟨🟨🟨🟨🪨🟨🟨🟨🟨🟨🟨🟨🟨🟨🌱🌱🌱🌱🌱🌱🌱🌱🌱🌱🟨🟨🟨🚫🚫🟨🟨🟨🟨🟨🟨🟨🟨🟨🟨🟨🟨🟨🟨🟨🟨🟨🟨🟨🟨🟨🟨🟨🟨🟨🟨🟨
🟦🟦🟨🟨🟦🟦🟦🟦🟦🟦🟦🟨🟨🟨🟦🟦🟦🟦🟦🟦🌳🟨🟨🟨🟨🟨🟨🟨🟩❎🟩❎🪨🟨🟨🪵🪵🪵❎🟨🟨🟨🪨🟨🟨🪨🪵🟩🌳🟨🟨🟨🪵🟨❎🟨🟨🪨🟨🪵🟨🟨🟨🟨🌱🌱🌱🌱🌱🌱🌱🌱🟨🟨🟨🟨🚫🟨🟨🟨🟨🪵🟩🟩🟩🟩🟩🟩🟩🟩🟩🟩🟨🟨🟩🟩🟩🟩🟩🟩🟩🟩🟩🟨🟨
🟦🟦🟦🟦🟦🟦🟦🟦🟦🟦🟦🟨🟨🟨🟦🟦🟦🟦🟦🟨🟨🟨🪨🪨❎🟨🪨🪵🟩🟩🟩🟩🟩🟩❎❎🟨🟨❎❎🟨🟨🟨❎🟨❎❎🟨🟨🟨❎❎🪵🟨🟨🟩🟩🟩🪨🟨🟨🟨🟨🌱🌱🌱🌱🌱🌱🌱🌱🌱🌱🟨🟨🟨🚫🟨🟨🟨🌱🪨🟩❎🟩🟩🟩🟩🟩🟩🟩🟩🪵🌳🟩🟩🟩🟩🟩🟩🟩🟩🟩🟨🟨
🟦🟦🟦🟦🟦🟦🟦🟦🟦🟦🟦🟦🟦🟦🟦🟦🟦🟦🟦🟨❎❎🟨🟨🪵🟨🟩🟩🟩🟩🟩🟩🟩🟩🟩🟨❎🟨🟨🪨🟨🌳🟨🪨🪵🟨🟨🪨🟨🟨🟨❎🟨❎🟨🟩🟩🟩🟩🌳🪨🟨🟨🌱🌱🌱🌱🌱🌱🌱🌱🌱🟨🟨🟨📦🟨🟨🟨🟨🪨🌱🟨🟩🟩🟩🟩🟩🟩❎🟨❎🟨🟩🟩🟩🟩🟩🟩🟩🟩🟩🟩🟨🟨
🟦🟦🟦🟦🟦🟦🟦🟦🟦🟦🟦🟦🟦🟦🟦🟦🟦🟦🟦🟨🟨🟨🟨🪨🟨🟨🟩🟩🟩🪵🟩🟩🪨🟩🟩🟨🟨🟨❎🟨🟨🟨🟨🪨❎🟨❎❎❎🪨🟨🌳🪨🟨❎🟩🟩🟩🟩🟩🟨🌳🟨🟨🌱🌱🌱🌱🌱🌱🌱🌱🟨🟨🟨🟨🟨🟨🟨🟨🌱🌱🟨🟨🟩🌳🟨🪵🟩🟨🟨🟨🪵🟨🟩❎🟩🟩🟩🟩🟩🟩🟩🟨🟨
🟦🟦🟦🟦🟦🟦🟦🟦🟦🟦🟦🟦🟦🟦🟦🟦🟦🟦🟨❎🟨🟨🟨🪨🟨🟩🟩🟩🟩🟩🟩🟩🟩🟩🟩🟩🟨🟨🟨❎🪨🪵❎🟨🟨🟨🟨❎🟨🪵🟨🪵🟨🟨🟩🟩🟩🟩🟩❎🪨🟨🟨🟨🌱🌱🌱🌱🌱🌱🌱🌱🌱🟨🟨🟨🟨🟨🟨🟨🌱🪨🟩🟩🟩🟩🪨🪨🪵🪨🪵🟨🪨🟨❎🟨🟨❎❎🟩🟩🟩🟨🟨🟨
🟦🟦🟦🟦🟦🟦🟦🟦🟦🟦🟦🟦🟦🟦🟦🟦🟦🟦🟨❎🪵🪨🟨🟨🟨🌳🟩🟩🟩🟩🟩🟩🟩🟩🟩🟩❎🟨🌳🌳🟨🟨🟨❎🟨🌳🪵🌳❎🌳🟨🟨❎🪨🟨🟩🟩🟩❎🟨🪵🟨🟨🌱🌱🌱🌱🌱🌱🌱🌱🌱🟨🌱🟨🟨🟨🟨🟨🟨🌱🌱🟨❎🟨🟩🟩❎🪨🟨🪨🟨🪵🪨🟨🟨🟨🪨🟩🟩🟩🌳🟨🟨🟨
🟦🟦🟦🟦🟦🟦🟦🟦🟦🟦🟦🟦🟦🟦🟦🟦🟦🟦🟨❎🟨🟨🟨🟨🟨🟩🟩🟩🪨🟩🟩🟩🪵🟩🟩🟩🟨❎🟨🪨🟨🪨🟨❎🟨🟨🟨🟨🪨🌳🌳🟨🟨🟨❎🟨❎❎🟨🪨❎❎🟨🪨🟨🟨🟨🟨🟨🌱🟨🟨🌱🌱🌱🌱🌱🌱🌱🌱🌱🟨🌱🟨❎🟨🟩🟨🪨❎🪵🟨🟨🪨❎❎🟨❎❎🟨🪵🪵🟨🟨🟨
🟦🟦🟦🟦🟦🟦🟦🟦🟦🟦🟦🟦🟦🟦🟦🟦🟦🟦🟦🟨🟨🪨❎🟨🟨❎🟩🟩🟩🟩🟩🟩🟩🟩🟩🟩🟩🟨🟨🟨🟨🟨🌳🪨🟨🟨❎🟨🟨❎🟨🟨❎🌳🟨❎🟨❎🟨🟨❎🟨🟨🟨🟨🟨🟨🟨🟨🟨🌱🌱🟨🌱🟨🟨🟨🟨🟨🟨🟨🌱🌱🟨🟨🟨🟨🟨🟨🟩🟩🟨❎🟨🟨🪵❎🟨🟨❎🟨❎🟨🟨🟨
🟨🟨🟨🟨🟨🟨🟦🟦🟦🟦🟦🟦🟦🟦🟦🟦🟦🟦🟦🟨🪵🟨🟨🟨❎🟨🪵🟩🟩🟩🟩🟩🟩🟩🟩🟩❎🟨🪵🟨❎🟨🟨🟨🪨🟨🌳🌳🟨🟨🟨🪨🟨❎❎🟨🟨🟨🟨❎🟨❎🟨🟨🪵🪨🟨🟨🟨🟨🟨🟨🌱🟨🟨🟨🟨🟨🟨🟨🟨🟨🌱🪨🪨🟨🟨🟨🟨🟨🟩🟨🟩🟩❎🪨🟨❎🪨🪵🪵🟨🟨🟨🟨
🟨🟨🟨🟨🟨🟨🟨🟦🟦🟦🟦🟦🟦🟦🟦🟦🟦🟦🟦🟨🪨❎🌳🟨🟨❎🟨🟨🟨🟩🟩🟩🟩🪨❎🟨🌳🟨✨🟨❎🟨🪨❎🟨❎🟨🟨❎❎🪵🟨🟨🌳🟨🟨🪵🟨❎🟨🟨🟨🌳🪨🟨🟨🟨🟨❎🟨🟨🌳🟨🟨🌳🟨🟨🌱🟨🟨🟨🟨🌱🟨🟨🟨🟨🟨🟨🟨🟩🟩🟩🟩🟩🪵🟨🟨🟨🪵🪵🌳🟨🟨🟨
🟨🟨🟨🟨🟨🟨🟨🟨🟦🟦🟦🟦🟦🟦🟦🟦🟦🟦❎🪵🟨🟨🟨🟨🟨🟨🟨❎🪨🟨❎🟩🟨🟨🟨❎🟨🟨❎🟨🌳🟨🟨🟨🌳🪨🟨❎❎🟨🟨❎🪨🟨🟨🌳🟨🪨🟨🟨🌳🟨🟨🟨🟨🟨🟨🟨🟨🟨🟨🟨🪨🪵🟨🟨🟨🌱🌱🌱🌱🌱🌱🟨🟨🟨🟨🟨🟨🟨🟨🟩🟩🟩🟩🟨❎❎🪵🪨🟩🟩🟩🟨🟨
🟨🟨🟨🟨🟨🟨🟨🟨🟨🟨🟦🟦🟦🟦🟦🟦🌳🟨🟨❎🪨❎🟨🟨🌳🟨🪵🟨❎🟨🪵🟨❎🌳🟨🟨🟨❎❎❎🟨🟨❎🟨🟨🟨🟨🟨❎🟨🟨🪨🌳🟨🟨🪨🟨🟨🟨❎🟨🪨🟨🟨🟨🟨🟨🟨🟨🟨🟨🟨🟨🟨🟨🟨🟨🟨🟨🟨🌳🟨🌳🟨🟨🟨🟨🟨🟨🟨🟨🟩🟩🟩🟩🟩🪨❎🟨🪨🟩🟩🟨🟨🟨
🟨🟨🟨🟨🟨🟨🟨🟨🟨🟨🟨🟨🟨🟨🟨🟨🟨🟨🪨🟨🟨🟨🟨🟨🟨🟨🪨🟨🟨🟨🟨🟨🟨🟨🟨🪵🪵🌳🟨🟨🪵🟨🟨🟨❎❎🪵🟨🟨🟨❎🟨🟨❎🟨🪨🟨🌳❎🟨🟨🪵🟨🪵🟨🟨🟨❎🟨🟨🟨🟨🪨🟨🟨🟨🟨🟨❎🪨🟨🟨🟨🟨🟨🟨🟨🟨🟨🟩🌳❎🟩🟩🟩🟩🟩❎🪨🪨🟩🟩🟩🟨🟨
🟨🟨🟨🟨🟨🟨🟨🟨🟨🟨🟨🟨🟨🟨🟨🟨🟨🟨🟨❎🟨🪨🟨🪵🟨🟨🟨🌳🌳🪵❎🟨🟨❎🟨🪵🪵🟨❎🟨🟨🌳🌳🟨🟨❎🟨🟨🌳🟨🟨🟨🪨❎🪵🟨🟨❎🟨🟨🟨🟨🟨🟨🟨🟨🪨🟨🌳❎🟨🪨❎🟨❎🪨🟨🟩🟩🟨🟨🪨🟨🟨🟨🟨🟨🪨🟨🟩🟩🟩🟩🟩🟩🟩🌳🟨🟨🟨🟩🟩🟩🟨🟨
🟨🟨🟨🟨🟨🟨🟨🟨🟨🟨🟨🟨🟨🟨🟨🟨🟨🪨🟨🪨🟨🟨❎🟨🟨🪨🟨🪨🟨🟨🟨🪨🟨❎🪵❎🌳🟨🟨🟨❎🟨🟨🟨🪨🟨❎🟨🟨❎🪨🪵🟨🟨🟨🟨❎🟨🟨🟨🪨🟨🟨🌳🪨🟨🟨❎🟨🟨❎❎🟨❎🟨🟨🟨🟩🟩🟩🪨❎❎🟨🟨🟨🟨🪵🟩🟨🟩🟩🟩🟩🟩🟩🟩🟩🌳🟨🟩🟨🟩🟨🟨
🟨🟨🟨🟨🟨🟨🟨🟨🟨🟨🟨🟨🟨🟨🟨🟨🟨🟨🟨🟨🟨🪨🟨❎🟨🟨🪵🟨🪨🟨🌳🟨🟩🟨❎❎🟨🟨🌳🟨🌳🟨🪨🟩🪨🟨🟨🟨🟨🟨🟨❎🟨🌳🟨🟨🟨🟨🟨🪵🌳🟨🟨🟨🌳🪨🟨🟨🌳🟨🟨🟨🟨🟨❎🟨🟨🟩🟩🟩🟩🟨🪵🌳🪨🪨🟨🟨🌳🟩🟩🟩🪵🟩🟩🟩🟩🟩🟩🟩🟨🟨🟨🟨🟨
🟨🟨🟨🟨🟨🟨🟨🟨🟨🟨🟨🟨🟨🟨🟨🟨🌳🟨❎🟨🟨❎❎🟨❎🟨🟨❎🟩🟩🟩🟩🟩❎🟨🟨🪵🟨🟨🪵🟨🟨🟨🟩🌳🟨🟨🪨❎🟨❎🟨🟨🟨🟨🟩❎🟩🌳🟨🟨🟨🟨🟨🪨🟨🌳🟨🪵🪨❎🟨🟨🌳🟨❎🟨🟩🟩🟩🟩❎🪵❎🟨🟨🟨🟨🟩🟩🟩🟩🟩🟩🟩🟩🟩🟩🟩🟨🟨🟨🟨🟨🟨
🟨🟨🟨🟨🟨🟨🟨🟨🟨🟨🟨🟨🟨🟨🟨🟨🪨❎🟨🪨🟨❎❎🟨🟨❎❎🟩🟩🟩🟩🟩🟩❎🟨🪵🟨🟨🟨🟨🟨🌳🟩🟩🌳🟨🟨❎🟩🪵🪵🟩🟩🟩🟨🟩🟩🟩🟨🟨🟨🟨🪵❎🟨🟨🟨❎🟨🌳🌳🟨🪨🟨🪨🟨🟨🟩🟩🟩🟩🌳🟨🪵🟨🟨🟨🪵🪵🟩🟩🟩🟨🪨🟩🟩🟩🪨🟩🟩🟨🟨🟨🟨🟨
🟨🟨🟨🟨🟨🟨🟨🟨🟨🟨🟨🟨🟨🟨🟨🟨🟨✨🪵🟨🟨🟨❎🟨🟨🪨🟩🟩🟩🟩🟩🟩🟩🟩🟨🟨🪵🟨🟨❎🟩🟩🟩🟩🟩🟩🟩🟩🟩🟩🟩🟩🟩🟩🟩🪵🪵🟩🪵🟨🟨🟩🟩🟩❎🟨❎🪵❎🟨🟨🟨🟨🪵🟨🪨🟨🟩🟩🟩🟩🟩❎❎🪨🟨🟨🪵🪵🟨🟨🟨🟨🟨🟩🟨🟨🟨🟨🟨🟨🟨🟨🟨🟨
🟨🟨🟨🟨🟨🟨🟨🟨🟨🟨🟨🟨🟨🟨🟨🟨🪨❎🟨🟨🟨❎🟨❎🪨🟩🟩🟩🟩🟩🟩🟩🟩🟩🪨🟨❎🪨❎🪵❎🟩🟩🟩🟩🟩🟩🟩🟩🟩🟩🟩🟩🪨🟩🪵🪵🟩🟩🟨🟨🟩🟩🟩🟩🟩🟩🌳🟨🟨🟨🌳🟨🟨🪨🟨🟨🟨🟨🟨🟨🟨🟨🟨🟨🟨🟨🟨🟨🟨🟨🟨🟨🟨🟨🟨🟨🟨🟨🟨🟨🟨🟨🟨🟨
🟨🟨🟨🟨🟨🟨🟨🟨🟨🟨🟨🟨🟨🟨🟨🟨🟨🟨🟨🌳❎🟨🟨🌳🟨❎🟩🟩🟩🪵🪵🟩🟩🟩❎🪵🪵🪵🟨🪨❎🟩🌳🟩🟩🟩🟩🟩🟩🟩🪵🟩🟩🟩🟩🟩🟨🟨🟨🟩🪵🪵🟩🟩🟩🟩🪨🟨🌳🟨🟨🟨❎🟨🟨❎🟨🟨🟩🌳🟨🟨🟨🪨🟨🟨🟨🟨🟨🟨🟨🟨🟨🟨🟨🟨🌳🟨🟩🟩🟨🟨🟨🟨🟨
🟨🟨🟨🟨🟨🟨🟨🟨🟨🟨🟨🟨🟨🟨🟨🟨❎🟨❎🟨🟨❎🪨🟨❎🟩🟩🟩🟩🪵🪵🟩🟩🟩🟩🪵🪵❎❎❎🟩🟩🟩🟩🟩🟩🪵🪵🟩🟩🟩🟩🟩🪵🪵🟨🟨🟩🟩🟩🪵🪵🟩🟩🟩🟨🟨🟨🟨🟨🪨🪨🟨❎❎🟨🟨🟨🟨🟨🟨🟨❎🟨🟩🟨🪨🪨🟨🪵🟨🟨🟨🟨🪵🪵❎❎🟩🟩🟨🟨🟨🟨🟨
🟨🟨🟨🟨🟨🟨🟨🟨🟨🟨🟨🟨🟨🟨🟨🟨🪨🟨🟨🟨🪵🟨🪨❎❎🌳🟩🟩🟩🟩🟩🟩🟩🟩❎❎❎🪨🪵🪵❎❎🟩🟩🪵🟩🪵🪵🟩🟩🟩🟩🟩🪵🪵🟨🟨🟩🟩🪨🟩🟩🟩🟩🟩🌳🟨❎🟨🟨🪵❎🟨🟨🟨❎🟨🟨🟨🟨🟨🟩🟩🟩🟩🟨🪵❎❎🟨🌳🟨🟨🟨🟨🟨❎🟨🪨🟨🟨🟨🟨🟨🟨
🟨🟨🟨🪵🪵🟨🟨🟨🟨🟨🟨🟨🟨🟨🟨🟨🟨🟨🟨❎❎🟨❎🟨❎❎🟩🟩🟩🟩🟩🟩🟩🟩🟩🪵🪨🟨🪵🪵🪨❎🟩🟩🟩🟩🟩🟩🟩🟩🟩🟩🟩🟨🟨🟨🟨🪵🪵🟩🟩🟩🟩🟩🟩🟩❎🟨❎🟨🟨🟨🌳🪨🟨🟨🟨🟨🌳🪵🪵🪨🟩❎❎🟨❎🟨🪨🪨🟨🟨🟨🟨🪵🟨🟨🌳🟨🟨🟨🟨🟨🟨🟨
🟨🟨🟨🪵🪵🟨🟨🟨🟨🟨🟨🟨🟨🟨🟨🟨❎🟨🟨🟨🟨❎🟨🟨🟨❎🪨🟩🟩🟩🟩🟩🟩🟩❎🪨🪨🪨🪨❎🪵🟨🟨🟩🌳🟩🟩🟩🪨🟩🟩🟩🟨🟨🟨🟨🟩🪵🪵🟩🟩🟩🪵🟩🟩❎🟨❎🟨🟨❎❎❎🟨❎❎🟨🟨🟨🟨❎🟩🟩🟩🟩❎❎🟨🟨🟨🟨🟨🟨🪨❎🟩❎🟨🟨❎❎🟨🟨🟨🟨
🟨🟨🟨🟨🟨🟨🟨🟨🟨🟨🟨🟨🟨🟨🟨🟨❎🟨🪵🪨❎🟨🟨🟨🌳🟨🟨🟩🟩🟩🟩🟩🟨🟨🟨🪨🪨🪨🟨🟨❎❎❎🟩🟩🟩🟩🟩🟩🟩🪵🪵🟨🟨🟨🟩🟩🟩🟩🟩🟩🟩🟩🌳🟩🟨🪨🌳🟨🟨🟨🪨🟨🪵🟨🟨🟨❎❎🟨❎🟨🪵🪨❎🟨🟨❎🪨🟨🟨🟨🟨🟨❎🟩🪨🟩🟩🟩❎🟩🟩🟨🟨
🟨🟨🟨🟨🟨🟨🟨🟨🟨🟨🟨🟨🟨🟨🟨🟨🟨❎🟨🟨🟨🟨❎🪨🪨🟨❎🟩❎🪨🟩🪵🟨🟨❎🟨🟨🪨🪵🟨❎🟨🟨❎🟨❎🟩🟩🟩🪨🪵🪵🟨🟨🪵🟩🟩🟩🌳🟩🟩🟩🟩🟩🟩🟨❎🟨🟨❎🟨❎🪵🟨🟨❎🟨🟨🟨🟨🟨❎🟨🪵🟨🟨🌳🟨🪨🟨🟨🟨🟨🟨❎🟩🟩🟩🟩🟩🟩🟩🟩🟨🟨
🟨🟨🟨🟨🟨🟨🪵🪵🟨🟨🟨🟨🟨🟨🟨🟨🪵🌳🟨❎🟨❎🪵🪵🟨🟨🟨🟨❎🟨🪨🟨🟨🌳🟨🟨🪵🪵🟨🟨🟨🟨🌳🟨❎🟨🟨🌳🟨🟨🟨🟨🟨🟨🟨🟩🟩🟩🟩🟩🟩🟩🟩🟩🌳❎🌳❎🟨🪵❎🟨🟨❎🪨🪨🟨🟨🟨🟨🪵❎🟨❎🟨❎🟨🟨🟨🟩🟩🟨🌳🟨🟩🟩🟩🟩🟩🟨🟨🟨🟨🟨🟨
🟨🟨🟨🟨🟨🟨🪵🪵🟨🟨🟨🟨🟨🟨🟨🟨🟨❎🟨🟨🪨🟨🟨🌳🟨🟨🟨🟨🌳🟨🟨🟨🪨🟨🟨🟨🟨🟨❎🟨🪵🟨🌳🪵🟨🟨❎🟨🟨🟨🟨🌳🟨🟨🟩🟩🌳🟩🟩🟩🟩🟩🟩🟩🟨🌳🟨🟨❎🪨🟨❎❎❎🟨❎🟨🟨🟨🟩🟨❎🟨🪵🪨🟨🟨🪵🟩🟩🟨🟨🟨🟩🟩🟩🪨🟩🟨🟨🌳❎🟨🟨🟨
🟨🟨🟨🟨🟨🟨🟨🟨🟨🟨🟨🟨🟨🟨🟨🟨🟨🟨🌳🟨🟨🟨🌳🟨🟨🪨🟨❎🟨❎🪨🟨🌳🪨🟨🟨❎🪵🟨🟨🪨🪨❎🟨🪨🟨🟨🟨🪨🟨🟨🟨❎🟨🪨🟨❎🟩❎🟩🌳🌳🟩🟨❎🟨❎🟨🟨❎❎🌳🟨🪵🟨🟨🟨🟨🟩🟩🟨❎🟨🟨🟨🟨🟨🟩🟩❎🟨🟨🟨🟨🟩🟩🟩🟨🪵🪵🟨🪨🟨🟨🟨
🟨🟨🟨🟨🟨🟨🟨🟨🟨🟨🟨🟨🟨🟨🟨🟨🟨🟨🟨🟨❎🌳❎🌳❎🟨🟨🌳🟨🟨🪵🟨❎🟨🟨🌳❎🟨🪨🟨🟨🌳🟨🪵🟨🌳🪨🪨🪨🟨🪨🟨🟨🟨🪨❎🟨🟨🟨🟨❎🟨🟩🟩🟨❎🟨❎🪨🟨🟨🟨❎❎🪨🟨🟨🟩🟩🟩🟩❎🟨🟨🟩🪨🟩🟩🟩🟩🟩🟨🟨🌳🟩🟩🟩❎🟨🟨🟨❎🟨🟨🟨
🟨🟨🟨🟨🟨🟨🟨🟨🟨🟨🟨🟨🟨🟨🟨🟨❎🟩🪵🟨🟨🟨❎🟨🟨🟨🟨❎🟨🟨🌳🟨🟨❎❎❎🟨🪵🪨🪨❎🪨❎🟨🟨🟨🟨🪨🪨🟨🟨🪨🟨🪨🪨🟨🟨❎🪨🪨🟨🟨❎🪨🟨🟨❎🟨🟨🪨🪨🪨❎🟨❎🟨🟨🟨🟨🟩🟩🟩🟨🪵🟩🟩🟩🟩🟩🟩🟨🟨🟨🟨🟩🟩❎🌳❎🟨❎❎🟨🟨🟨
🟨🟨🟨🪵🪵🟨🟨🟨🟨🟨🟨🟨🟨🟨🟨🟩🟩🟩🟩🟨🌳🟨🟨❎🟨🌳🟨🟨🪵🟨🟨🟨🟨🟨🟨🟨🪨🟨🪨🪨🌳🟨🟨🟨🌳❎🟨🪨🟨🟨🪨🟨🪨🪨🪨❎🟨❎❎🪨🪨🪨🟨🟨🪨🟨❎🪨🟨🪨🪨🟨❎🪨🟨❎🟨🟨🟨🟨🟨🟨🟨🟨🌳🪵🪵🟩🟩🟩🟨🟨🟨🟨🪨🟨🪵🟨🪵🪵🟨❎🟨🟨🟨
🟨🟨🟨🪵🪵🟨🟨🟨🟨🟨🟨🟨🟨🟨🟨🟩🟩🌳🟨🪨🟨🪵🪨🟨🟨🪨🟨❎🟨❎🟨🪨🟨🌳🟨🪨🪨🪨🟨❎🟨❎🪵❎🟨🟨🟨🟨🟨🟨🟨🟨🟨🪨🟨🟨🪨🪨🟨🪨🪨❎🪨🪨🪨🪨🟨🟨🪨🟨🪵❎🟨🟨🟨🟨🟨🟨🟨🟨🟨❎🟨🌳🟨🪵🪵🪨🟩🟩🟨🟨🟨🟨🟩🟨❎❎🪵🪵❎🟨🟨🟨🟨
🟨🟨🟨🟨🟨🟨🟨🟨🟨🟨🟨🟨🟨🟨🟨🟨❎🟨🪨🟨🟨🟨🟨🪨🪨🪨🟨🟨🟨🟨🟨🟨🪨🟨🟨🟨🪨🪨❎🟨❎🪨🟨🟨🟨🪵🟨🟨🟨🪨❎🪨🟨🪵🟨🪨🪨❎🟨❎❎🪨❎🟨🪨🪨🟨🪨🟨❎🪨🟨🟨🟨🟨❎🟨🟨🟨🟨🟨🟨❎🟨❎❎❎🟨🟩🟩🟨🟨🟨🟨🟩🟩🟨🪵❎🪵🟩🟩🟩🟨🟨
🟨🟨🟨🟨🟨🟨🪵🪵🟨🟨🟨🟨🟨🟨🟨🟨🟨🟨🟨🟨🟨🟨❎🪨🪨🟨🪵🟨🟨🟨🟨❎❎🟨❎🪨🪨🟨🌳🪨🪨🟨🌳🟨🟨🟨🟨🟨🪨🟨🪨🟨🪨🟨🪨🪨🪨🟨❎❎🟨🪨🪵🪨🪵🟨🪨❎❎❎❎🟨❎🟨❎❎🟨🟨🟨🟨🟨🟨❎🟨🟨❎🟨🟩🪵🟩🟨🟨🟨🟨🟩🟩❎🪨🟨❎🪨🟩🟩🟨🟨
🟨🟨🟨🟨🟨🟨🪵🪵🟨🟨🟨🟨🟨🟨🟨🟨🟨🟨🟨❎🟨🟨🟨🪵❎🟨🟨❎🟨🪵🟨🟨🟨🪨🪨❎🪵❎🟨🟨🟨❎🟨🟨🟨🟨🟨🟨🪨🟨❎🟨🪨🪨🪨🟨🪨🟨🪨🪨🪨🟨❎🟨🟨🪨🪨🌳🟨❎🟨🪨🟨🪵❎🪨🟦🟦🟦🟦🟦🟦🟦🟨❎🟨🟩🟩🟨🌳🟨🟨🟨🟨🟩🟩🌳🟨🟩🟩🟩🟩🟩🟨🟨
🟨🟨🟨🟨🟨🟨🟨🟨🟨🟨🟨🟨🟨🟨🟨🟨🟨🟨🌳🟨🟨🟨🟨🌳🪨🟨🟨🟨❎🟨🟨❎🟨🪨🪨❎🪵🟨🟨🌳🟨❎🟨🪵🪨🟨🪨🪨🟨🪨🟨❎❎🪨🪨🟨🪨❎🟨🟨🟨🟨🪨🪨🪨🟨❎🟨❎❎🟨❎❎🟨🟨❎🟦🟦🟦🟦🟦🟦🟦🟨🟨🟨🟩🟩🟩🟩🟨🟨🟨🪨🟩🟩🟩🟨🌳🟩🪨🟩🟩🟨🟨
🟨🟨🟨🟨🟨🟨🟨🟨🟨🟨🟨🟨🟨🟨🟨🟨🟨🟨🟨🪨🪨🟨❎🟨🪵❎🟨🟨🟨❎🌳🟨🟨🟨🟨🟨🟨🪵🟨🟨🟨🟨🟨🟨🪨🟨🪨🪨🪨🟨🪨❎🟨🟨🪨🟨🪨🪨🟨🪨🟨❎🪨🟨❎❎🟨❎🟨🪵❎🟨❎🟨🪨🪨🟦🟦🟦🟦🟦🟦🟦🟦🟦🟦🟦🟩🟨🟨🟨🟨🟨🟨🟩🟩🟩🟩❎🟨🪵🟨🟩🟨🟨
🟨🟨🟨🟨🟨🟨🟨🟨🟨🟨🟨🟨🟨🟨🟨🟨🟨🟨🪵🟨🟨🟨🟨🟨❎🟨🟨❎🟨🟨🟨🟨🟨❎🟨🪵🟨🟨🟨🟨🟨🟨🪵🟨🟨🟨🟨🪨🟨🪨🟨🪵🪨❎🟨🟨🪨🪨🟨🟨❎🟨🟨❎🪵🟨🟨🟨❎🪨🟨❎🪨❎🟨❎🟨🟦🟦🟦🟦🟦🟦🟦🟦🟦🟦🟦🟨🟨🟨🟨🟨🟨🪵🟩🟩❎❎🟨🟨🟨🟨🟨🟨
🟨🟨🟨🟨🟨🟨🟨🟨🟨🟨🟨🟨🟨🟨🟨🟨🟨🟨🟨🟨❎🟨🌳🟨🟨🟨🪨🟨🟨🪵❎🟨❎🟨🟨🟨🟨❎🟨🟨🪨🟨🟨🟨🟨🪵🟨🟨❎🟨🪨🟨🟨🟨❎❎🟨🟨🪵❎🟨🟨🟨❎❎🟨❎❎🟨❎❎🌳🟨🪵🌳🟨🟨🟦🟦🟦🟦🟦🟦🟦🟦🟦🟦🟦🟦🟦🟦🟦🟨🟨🟨🟨🟨🟨🟨🟨🟨🟨🟨🟨🟨
🟨🟨🟨🟨🟨🟨🟨🟨🟨🟨🟨🟨🟨🟨🟨🟨🟨🟨🟨🟨🪨🟨🟨🟨🟨🟨🟨🟨🟨❎🟨❎🟨❎❎🪵🟨🟨🟨🟨🟨🟨🟨🟨🟨🟨🟨🟨🟨❎🟨🟨🟨🟨🟨🟨❎🟨🟨🟨🟨🌳🟨🟨🟨🟨🟨❎🪨🟨🟨🟨❎❎🪨🟨🟦🟦🟦🟦🟦🟦🟦🟦🟦🟦🟦🟦🟦🟦🟦🟦🟨🟨🟨🟨🟨🟨🟦🟦🟦🟦🟦🟨🟨
🟨🟨🟨🟨🟨🟨🟨🟨🟨🟨🟨🟨🟨🟨🟨🟨🟨🟨🟨🟨🟨❎❎🟨🟨🪵🪵🪵🟨🟨🟨🟨🟨🟨🟨🟨🟨🟨🟨🟨🟨🟨🟨🟨🟨🟨🟨🟨🟨🟨🟨🟨🟨🟨🟨🟨🟨🟨🟨🟨🟨🟨🟨🟨🟨🟨🟨❎🟨🟨🟨🟦🟦🟦🟦🟦🟦🟦🟦🟦🟦🟦🟦🟦🟦🟦🟦🟦🟦🟦🟦🟦🟦🟦🟦🟦🟦🟦🟦🟦🟦🟦🟦🟦🟦
🟨🟨🟨🟨🟨🟨🟨🟨🟨🟨🟨🟨🟨🟨🟨🟨🟨🟨🟨🟨🟨🟨🟨🟨🟨❎🪵🟨🪵🟨🟨🟨🟨🟨🟨🟨🟨🟨🟨🟨🟨🟨🟨🟨🟨🟨🟨🟨🟨🟨🟨🟨🟨🟨🟨🟨🟨🟨🟨🟨🟨🟨🟨🟨🟨🟨🟨🟨🟨🟨🟨🟦🟦🟦🟦🟦🟦🟦🟦🟦🟦🟦🟦🟦🟦🟦🟦🟦🟦🟦🟦🟦🟦🟨🟨🟨🟦🟦🟦🟦🟦🟦🟦🟦🟦
🟨🟨🟨🟨🟨🟨🟨🟨🟨🟨🟨🟨🟨🟨🟨🟨🟨🟨🟨🟨🟨🟨🟨🟨🟨🟨🟨🟨🟨🟨🟨🟨🟨🟨🟨🟨🟨🟨🟨🟨🟨🟨🟨🟨🟨🟨🟨🟨🟨🟨🟨🟨🟨🟨🟨🟨🟨🟨🟨🟨🟨🟨🟨🟨🟨🟨🟨🟨🟨🟨🟨🟦🟦🟦🟦🟦🟦🟦🟦🟦🟦🟦🟦🟦🟦🟦🟦🟦🟦🟦🟦🟦🟦🟨🟨🟨🟦🟦🟦🟦🟦🟦🟦🟦🟦
🟨🟨🟨🟨🟨🟨🟨🟨🟨🟨🟨🟨🟨🟨🟨🟨🟨🟨🟨🟨🟨🟨🟨🟨🟨🟨🟨🟨🟨🟨🟨🟨🟨🟨🟨🟨🟨🟨🟨🟨🟨🟨🟨🟨🟨🟨🟨🟨🟨🟨🟨🟨🟨🟨🟨🟨🟨🟨🟨🟨🟨🟨🟨🟨🟨🟨🟨🟨🟨🟨🟨🟦🟦🟦🟦🟦🟦🟦🟦🟦🟦🟨🟨🟦🟦🟦🟦🟦🟦🟦🟦🟦🟦🟦🟦🟦🟦🟦🟦🟦🟦🟦🟦🟦🟦
🟨🟨🟨🟨🟨🟨🟨🟨🟨🟨🟨🟨🟨🟨🟨🟨🟨🟨🟨🟨🟨🟨🟨🟨🟨🟨🟨🟨🟨🟨🟨🟨🟨🟨🟨🟨🟨🟨🟨🟨🟨🟨🟨🟨🟨🟨🟨🟨🟨🟨🟨🟨🟨🟨🟨🟨🟨🟨🟨🟨🟨🟨🟨🟨🟨🟨🟨🟨🟨🟨🟨🟦🟦🟦🟦🟦🟦🟦🟦🟦🟦🟨🟨🟦🟦🟦🟦🟦🟦🟦🟦🟦🟦🟦🟦🟦🟦🟦🟦🟦🟦🟦🟦🟦🟦
🟨🟨🟨🟨🟨🟨🟨🟨🟨🟨🟨🟨🟨🟨🟨🟨🟨🟨🟨🟨🟨🟨🟨🟨🟨🟨🟨🟨🟨🟨🟨🟨🟨🟨🟨🟨🟨🟨🟨🟨🟨🟨🟨🟨🟨🟨🟨🟨🟨🟨🟨🟨🟨🟨🟨🟨🟨🟨🟨🟨🟨🟨🟨🟨🟨🟨🟨🟨🟨🟨🟨🟨🟨🟦🟦🟦🟦🟦🟦🟦🟦🟦🟦🟦🟦🟦🟦🟦🟦🟦🟦🟦🟦🟦🟦🟦🟦🟦🟦🟦🟦🟦🟦🟦🟦
🟨🟨🟨🟨🟨🟨🟨🟨🟨🟨🟨🟨🟨🟨🟨🟨🟨🟨🟨🟨🟨🟨🟨🟨🟨🟨🟨🟨🟨🟨🟨🟨🟨🟨🟨🟨🟨🟨🟨🟨🟨🟨🟨🟨🟨🟨🟨🟨🟨🟨🟨🟨🟨🟨🟨🟨🟨🟨🟨🟨🟨🟨🟨🟨🟨🟨🟨🟨🟨🟨🟨🟨🟨🟦🟦🟦🟦🟦🟦🟦🟦🟦🟦🟦🟦🟦🟦🟦🟦🟦🟦🟦🟦🟦🟦🟦🟦🟦🟦🟦🟦🟦🟦🟦🟦
🟨🟨🟨🟨🟨🟨🟨🟨🟨🟨🟨🟨🟨🟨🟨🟨🟨🟨🟨🟨🟨🟨🟨🟨🟨🟨🟨🟨🟨🟨🟨🟨🟨🟨🟨🟨🟨🟨🟨🟨🟨🟨🟨🟨🟨🟨🟨🟨🟨🟨🟨🪨🟨🟨🪨🪨🟨🟨🪨🟨🟨🟨🟨🟨🟨🟨🟨🟨🟨🟨🟨🟨🟨🟦🟦🟦🟦🟦🟦🟦🟦🟦🟦🟦🟦🟦🟦🟦🟦🟦🟦🟦🟦🟦🟦🟦🟦🟦🟦🟦🟦🟦🟦🟦🟦
🟨🟨🟨🟨🟨🟨🟨🟨🟨🟨🟨🟨🟨🟨🟨🟨🟨🟨🟨🟨🟨🟨🟨🟨🟨🟨🟨🟨🟨🟨🟨🟨🟨🟨🟨🟨🟨🟨🟨🟨🟨🟨🟨🟨🟨🟨🟨🪨🪨🟨🟨🟨🟨🪨🟨🪨🪨🟨🟨🪨🪨🪨🟨🟨🟨🟨🟨🟨🟨🟨🟨🟨🟨🟨🟦🟦🟦🟦🟦🟦🟦🟦🟦🟦🟦🟦🟦🟦🟦🟦🟦🟦🟦🟦🟦🟦🟦🟦🟦🟦🟦🟨🟨🟦🟨
🟨🟨🟨🟨🟨🟨🟨🟨🟨🟨🟨🟨🟨🟨🟨🟨🟨🟨🟨🟨🟨🟨🟨🟨🟨🟨🟨🪵🪵🟨🟨🟨🟨🟨🟨🟨🟨🟨🟨🟨🟨🟨🟨🟨🟨🟨🪨🪨🪨🟨🪨🪨🪨🟨🟨🟨🪨🟨🟨🪨🪨🟨🟨🟨🟨🟨🟨🟨🟨🟨🟨🟨🟨🟨🟦🟦🟦🟦🟦🟦🟦🟦🟦🟦🟦🟦🟦🟦🟦🟦🟦🟦🟦🟦🟦🟦🟦🟦🟦🟦🟨🟨🟨🟦🟦
🟨🟨🟨🪵🪵🟨🟨🟨🟨🟨🟨🟨🟨🟨🟨🟨🟨🟨🟨🟨🟨🟨🟨🟨🟨🟨🟨🪵🪵🟨🟨🟨🟨🟨🟨🟨🟨🟨🟨🟨🟨🟨🟨🟨🟨🟨🟨🟨🟨🪨🟨🪨🪨🪨🟨🟨🟨🪨🪨🪨🪨🟨🪨🟨🟨🟨🟨🟨🟨🟨🟨🟨🟨🟨🟨🟨🟨🟦🟦🟦🟦🟦🟦🟦🟦🟦🟦🟦🟦🟦🟦🟦🟦🟦🟦🟦🟦🟦🟦🟦🟦🟨🟨🟨🟨
🟨🟨🟨🪵🪵🟨🟨🟨🟨🟨🟨🟨🟨🟨🟨🟨🟨🟨🟨🟨🟨🟨🟨🟨🟨🟨🟨🟨🟨🟨🟨🟨🟨🟨🟨🟨🟨🟨🟨🟨🟨🟨🟨🟨🟨🟨🟨🪨🟨🟨🪨🟨🪨🪨🪨🟨🪨🟨🪨🟨🪨🟨🟨🟨🟨🟨🟨🟨🟨🟨🟨🟨🟨🟨🟨🟨🟨🟨🟦🟦🟦🟦🟦🟦🟦🟦🟦🟦🟦🟦🟦🟦🟦🟦🟦🟦🟦🟦🟦🟦🟦🟦🟦🟦🟦
🟨🟨🟨🟨🟨🟨🟨🟨🟨🟨🟨🟨🟨🟨🟨🪵🪵🟨🟨🟨🟨🟨🟨🟨🟨🟨🟨🟨🟨🟨🟨🟨🟨🟨🟨🟨🟨🟨🟨🟨🟨🟨🟨🟨🟨🟨🟨🟨🪨🪨🟨🟨🪨🟨🪨🟨🟨🪨🟨🪨🪨🟨🟨🟨🪨🪨🪨🪨🟨🟨🟨🟨🟨🟨🟨🟨🟨🟨🟦🟦🟦🟦🟦🟦🟦🟦🟦🟦🟦🟦🟦🟦🟦🟦🟦🟦🟦🟦🟦🟦🟦🟦🟦🟦🟦
🟨🟨🟨🟨🟨🟨🟨🟨🟨🟨🟨🟨🟨🟨🟨🪵🪵🟨🟨🟨🟨🟨🟨🟨🟨🟨🟨🟨🟨🟨🟨🟨🟨🟨🟨🟨🟨🟨🟨🟨🟨🟨🟨🟨🟨🟨🟨🟨🪨🪨🟨🪨🟨🟨🪨🪨🟨🟨🟨🪨🪨🟨🪨🟨🟨🪨🪨🪨🟨🟨🟨🟨🟨🟨🟨🟨🟨🟨🟦🟦🟦🟦🟦🟦🟦🟦🟦🟦🟦🟦🟦🟦🟦🟦🟦🟦🟦🟦🟦🟦🟦🟦🟦🟦🟦
🟨🟨🟨🟨🟨🟨🟨🟨🟨🟨🟨🟨🟨🟨🟨🟨🟨🟨🟨🟨🟨🟨🟨🟨🟨🟨🟨🟨🟨🟨🟨🟨🟨🟨🟨🟨🟨🟨🟨🟨🟨🟨🟨🟨🟨🟨🟨🪨🪨🪨🪨🟨🪨🟨🪨🪨🪨🟨🟨🪨🟨🟨🟨🪨🪨🟨🟨🪨🟨🟨🟨🟨🟨🟨🟨🟨🟨🟨🟦🟦🟦🟦🟦🟦🟦🟦🟦🟦🟦🟦🟦🟦🟦🟦🟦🟦🟦🟦🟦🟦🟦🟦🟦🟦🟦
🟨🟨🟨🟨🟨🟨🟨🟨🟨🟨🟨🟨🟨🟨🟨🟨🟨🟨🟨🟨🟨🟨🟨🟨🟨🟨🟨🟨🟨🟨🟨🟨🟨🟨🟨🟨🟨🟨🟨🟨🟨🟨🟨🟨🟨🟨🟨🟨🪨🟨🟨🪨🟨🪨🪨🟨🪨🟨🟨🟨🟨🟨🟨🟨🟨🟨🟨🟨🟨🟨🟨🟨🟨🟨🟨🟨🟨🟨🟦🟦🟦🟦🟦🟦🟦🟨🟨🟦🟦🟦🟦🟦🟦🟦🟦🟦🟦🟦🟦🟦🟦🟦🟦🟦🟦
🟨🟨🟨🟨🟨🟨🟨🟨🟨🟨🪵🪵🟨🟨🟨🟨🟨🟨🟨🟨🟨🟨🟨🟨🟨🟨🟨🟨🟨🟨🟨🟨🟨🟨🟨🟨🟨🟨🟨🟨🟨🟨🟨🟨🟨🟨🟨🟨🟨🟨🟨🟨🟨🟨🟨🟨🪨🪨🪨🟨🟨🟨🟨🪨🪨🪨🪨🪨🟨🟨🟨🟨🟨🟨🟨🟨🟨🟨🟦🟦🟦🟦🟦🟦🟦🟨🟨🟨🟦🟨🟦🟦🟦🟦🟦🟦🟦🟦🟦🟦🟦🟦🟦🟦🟦
🟨🟨🟨🟨🟨🟨🟨🟨🟨🟨🪵🪵🟨🟨🟨🟨🟨🟨🟨🟨🟨🟨🟨🟨🟨🟨🪵🪵🟨🟨🟨🟨🟨🟨🟨🟨🟨🟨🟨🟨🟨🟨🟨🟨🟨🟨🟨🟨🟨🟨🟨🟨🟨🟨🪨🪨🟨🪨🪨🪨🟨🪨🪨🪨🟨🪨🪨🟨🟨🟨🟨🟨🟨🟨🟨🟨🟨🟨🟨🟦🟦🟦🟦🟦🟦🟦🟦🟦🟦🟦🟦🟦🟦🟦🟦🟦🟦🟦🟦🟦🟦🟦🟦🟦🟦
🟨🟨🟨🟨🟨🟨🟨🟨🟨🟨🟨🟨🟨🟨🟨🟨🟨🪵🪵🟨🟨🟨🟨🟨🟨🟨🪵🪵🟨🟨🟨🟨🟨🟨🟨🟨🟨🟨🟨🟨🟨🟨🟨🟨🟨🟨🟨🟨🟨🟨🟨🟨🟨🟨🟨🪨🪨🟨🟨🪨🟨🪨🪨🟨🪨🪨🟨🪨🟨🟨🟨🟨🟨🟨🟨🟨🟨🟨🟨🟦🟦🟦🟦🟦🟦🟦🟦🟦🟦🟦🟦🟦🟦🟦🟨🟨🟦🟦🟦🟦🟦🟦🟦🟦🟦
🟨🟨🟨🟨🟨🟨🟨🟨🟨🟨🟨🟨🟨🟨🟨🟨🟨🪵🪵🟨🟨🟨🟨🟨🟨🟨🟨🟨🟨🟨🟨🟨🟨🟨🟨🟨🟨🟨🟨🟨🟨🟨🟨🟨🟨🟨🟨🟨🟨🟨🟨🟨🟨🟨🟨🟨🪨🟨🟨🟨🟨🟨🪨🟨🟨🟨🟨🟨🟨🟨🟨🟨🟨🟨🟨🟨🟨🟨🟨🟦🟦🟦🟦🟦🟦🟦🟦🟦🟦🟦🟦🟦🟦🟦🟨🟨🟦🟦🟦🟦🟦🟦🟦🟦🟦
🟨🟨🟨🟨🟨🟨🟨🟨🟨🟨🪵🪵🟨🟨🟨🟨🟨🟨🟨🟨🟨🟨🟨🟨🟨🟨🟨🟨🟨🟨🟨🟨🟨🟨🟨🟨🟨🟨🟨🟨🟨🟨🟨🟨🟨🟨🟨🟨🟨🟨🟨🟨🟨🟨🟨🟨🟨🟨🟨🟨🟨🟨🟨🟨🟨🟨🟨🟨🟨🟨🟨🟨🟨🟨🟨🟨🟨🟨🟨🟦🟦🟦🟦🟦🟦🟦🟦🟦🟦🟦🟦🟦🟦🟦🟦🟦🟦🟦🟦🟦🟦🟦🟦🟦🟦
🟨🟨🟨🟨🟨🟨🟨🟨🟨🟨🪵🪵🟨🟨🟨🟨🟨🟨🟨🟨🟨🟨🟨🟨🟨🟨🟨🟨🟨🟨🟨🟨🟨🟨🟨🟨🟨🟨🟨🟨🟨🟨🟨🟨🟨🟨🟨🟨🟨🟨🟨🟨🟨🟨🟨🟨🟨🟨🟨🟨🟨🟨🟨🟨🟨🟨🟨🟨🟨🟨🟨🟨🟨🟨🟨🟨🟨🟨🟨🟦🟦🟦🟦🟦🟦🟦🟦🟦🟦🟦🟦🟦🟦🟦🟦🟦🟦🟦🟦🟦🟦🟦🟦🟦🟦
🟨🟨🟨🟨🟨🟨🟨🟨🟨🟨🟨🟨🟨🟨🟨🟨🟨🟨🟨🟨🟨🟨🟨🟨🟨🟨🟨🟨🟨🟨🟨🟨🟨🟨🟨🟨🟨🟨🟨🟨🟨🟨🟨🟨🟨🟨🟨🟨🟨🟨🟨🟨🟨🟨🟨🟨🟨🟨🟨🟨🟨🟨🟨🟨🟨🟨🟨🟨🟨🟨🟨🟨🟨🟨🟨🟨🟨🟨🟨🟦🟦🟦🟦🟦🟦🟦🟦🟦🟦🟦🟦🟦🟦🟦🟦🟦🟦🟦🟦🟦🟦🟦🟦🟦🟦